review	aspect	sentiment
But the staff was so horrible to us.	staff	-1
To be completely fair, the only redeeming factor was the food, which was above average, but couldn't make up for all the other deficiencies of Teodora.	food	1
The food is uniformly exceptional, with a very capable kitchen which will proudly whip up whatever you feel like eating, whether it's on the menu or not.	food	1
Not only was the food outstanding, but the little 'perks' were great.	food	1
Our agreed favorite is the orrechiete with sausage and chicken (usually the waiters are kind enough to split the dish in half so you get to sample both meats).	orrechiete with sausage and chicken	1
The Bagels have an outstanding taste with a terrific texture, both chewy yet not gummy.	Bagels	1
Nevertheless the food itself is pretty good.	food	1
They did not have mayonnaise, forgot our toast, left out ingredients (ie cheese in an omelet), below hot temperatures and the bacon was so over cooked it crumbled on the plate when you touched it.	mayonnaise	0
It took half an hour to get our check, which was perfect since we could sit, have drinks and talk!	check	0
The design and atmosphere is just as good.	design	1
He has visited Thailand and is quite expert on the cuisine.	cuisine	1
The pizza is the best if you like thin crusted pizza.	pizza	1
All the money went into the interior decoration, none of it went to the chefs.	interior decoration 1
The seats are uncomfortable if you are sitting against the wall on wooden benches.	seats	-1
I asked for seltzer with lime, no ice.	seltzer with lime	0
Don't go alone---even two people isn't enough for the whole experience, with pickles and a selection of meats and seafoods.	pickles	1
My suggestion is to eat family style because you'll want to try the other dishes.	eat family style	1
Best of all is the warm vibe, the owner is super friendly and service is fast.	vibe	1
Great food at REASONABLE prices, makes for an evening that can't be beat!	food	1
this little place has a cute interior decor and affordable city prices.	interior decor	1
Two words: Free wine.	wine	1
The price is reasonable although the service is poor.	price	1
The quantity is also very good, you will come out satisfied.	quantity	1
I stumbled upon this second floor walk-up two Fridays ago when I was with two friends in town from L.A. Being serious sushi lovers, we sat at the sushi bar to be closer to the action.	sushi	0
The fried rice is amazing here.	fried rice	1
Three courses - choices include excellent mussels, puff pastry goat cheese and salad with a delicious dressing, and a hanger steak au poivre that is out of this world.	courses	1
it's a perfect place to have a amanzing indian food.	indian food	1
The place is so cool and the service is prompt and curtious.	place	1
At the end you're left with a mild broth with noodles that you can slurp out of a cup.	broth with noodles	1
I just wonder how you can have such a delicious meal for such little money.	meal	1
The wine list is excellent.	wine list	1
They wouldnt even let me finish my glass of wine before offering another.	glass of wine	0
Whem asked, we had to ask more detailed questions so that we knew what the specials were.	specials	0
This is a consistently great place to dine for lunch or dinner.	dine	1
Nice atmosphere, the service was very pleasant and the desert was good.	atmosphere	1
After really enjoying ourselves at the bar we sat down at a table and had dinner.	bar	1
Try the lasagnette appetizer.	lasagnette appetizer	1
I liked the beer selection!	beer selection	1
Great food, good size menu, great service and an unpretensious setting.	food	1
Go here for a romantic dinner but not for an all out wow dining experience.	dinner	1
I grew up eating Dosa and have yet to find a place in NY to satisfy my taste buds.	Dosa	0
Wine list selection is good and wine-by-the-glass was generously filled to the top.	Wine list selection	1
With the great variety on the menu , I eat here often and never get bored .	menu	1
The menu is very limited - i think we counted 4 or 5 entrees.	menu	-1
The menu is limited but almost all of the dishes are excellent.	menu	1
Not too crazy about their sake martini.	sake martini	-1
Great bagels, spreads and a good place to hang out in.	bagels	1
One thing I liked about this place is that I never felt rushed or pressured to give up my table ot incoming guests.	table	0
Unfortunately, the food is outstanding, but everything else about this restaurant is the pits.	food	1
We always have a delicious meal and always leave feeling satisfied.	meal	1
Dip the ingredients in with your chopsticks, swirl them around, and eat.	ingredients	0
First went here to enjoy their garden terrace.	garden terrace	1
The pizza was pretty good and huge.	pizza	1
I almost hesititate to write a review because the atmosphere was so great and I would hate for it too become to crowded.	atmosphere	1
They are often crowded on the weekends but they are efficient and accurate with their service.	crowded	1
All my co-workers were amazed at how small the dish was.	dish	-1
We ordered the special, grilled branzino, that was so infused with bone, it was difficult to eat.	grilled branzino	-1
The wait staff is friendly, and the food has gotten better and better!	wait staff	1
Right off the L in Brooklyn this is a nice cozy place with good pizza.	place	1
I also ordered for delivery and the restaurant forgot half the order.	order	-1
Our server checked on us maybe twice during the entire meal.	server	0
The strong scents coming from the left and right of me negatively affected my taste buds.	scents	-1
We had the lobster sandwich and it was FANTASTIC.	lobster sandwich	1
Had we been stalling I could understand where they were coming from, but we had been there less than an hour and they hadn't even brought us a check yet!	check	-1
Deep Fried Skewers are good and still rare to find in NYC.	Deep Fried Skewers	1
I have tried to make reservations, but both times, the hostess didn't have my name.	reservations	0
I also recommend the rice dishes or the different varieties of congee (rice porridge).	rice dishes	1
Their tuna tartar appetizer is to die for.	tuna tartar appetizer	1
An oasis of refinement:  Food, though somewhat uneven, often reaches the pinnacles of new American fine cuisine - chef's passion (and kitchen's precise execution) is most evident in the fish dishes and soups.	cuisine	1
If you love wine and cheese and delicious french fare, you'll love Artisanal!	wine	1
I love Indian food and consider myself to be quite an expert on it.	Indian food	1
Some baby pizzas get their wish.	baby pizzas	0
Overall A oh ya even though there is waiting it is deff worth it	waiting	-1
The lava cake dessert was incredible and I recommend it.	lava cake dessert	1
VT is what baby pizzas hope to be when they grow up.	baby pizzas	0
From the terrible service, to the bland food, not to mention the unaccommodating managers, the overall experience was horrible.	service	-1
Lahore is a great place to duck into late-night when you need some really tasty food on the cheap -- you'll likely have trouble finishing the amount of food you get for FOUR DOLLARS.	food	1
The last time I went we were seated at a table in a corridor next to the kitchen.	table	-1
Nice restaurant overall, with classic upscale Italian decor.	Italian decor	1
The entire dining experience was wonderful!	dining experience	1
The wine selection (by the glass and bottle) is wonderful and I always recommend that friends make a reservation if they're going to be in town.	wine selection	1
Service is highly refined: our seating was delayed 35 minutes past our reservation and the maitre d' apologized and regularly kept us apprised of progress.	Service	1
Order the panang duck, it's fantastic.	panang duck	1
Food is usually very good, though ocasionally I wondered about freshmess of raw vegatables in side orders.	raw vegatables	-1
Other than the crappy service from two individuals, it's great.	service	-1
They have authentic Indian at amazin prices.	Indian	1
Ambiance- relaxed and stylish.	Ambiance	1
Luckily we saved room for the BBQ Salmon, Sea Bass and Crispy Duck.	BBQ Salmon	1
Yes, they use fancy ingredients, but even fancy ingredients don't make for good pizza unless someone knows how to get the crust right.	ingredients	1
and yes Dal Bukhara is so dam good and so are all the kababs.	Dal Bukhara	1
I look forward to eating here again	eating	1
I've been coming here as a child and always come back for the taste.	taste	1
A glass of Leaping Lizard, a glass of prosecco, and the mussels had everything happy.	glass of Leaping Lizard	1
Food was average and creme brulee was awful - the sugar was charred, not caramelized and smelled of kerosene.	Food	0
The food always tastes fresh and served promptly.	food	1
The pizza here is delicious.	pizza	1
Pizza and garlic knots are great as well, I order from them quite often and the delivery is always super quick!	Pizza	1
For great chinese food nearby, you have Wu Liang Ye and Grand Sichuan just a block away.	chinese food	1
But who says Murray's is anything about service.	service	0
This place is really trendi but they have forgotten about the most important part of a  restaurant, the food.	food	-1
Service could be improved but overall this is a place that understands the importance of little things (the heavy, black, antique-seeming teapot, for one) in the restaurant experience.	Service	1
The pizza is delicious - they use fresh mozzarella instead of the cheap, frozen, shredded cheese common to most pizzaria's.	pizza	1
service is friendly, and never had a problem walking in and getting a table.	service	1
The atmosphere was crowded but it was a great bistro-type vibe.	bistro-type vibe	1
First off, the waitress was completely unattentive the 2 times we saw her(odd in a restaurant with 6 tables) and got our order wrong.	waitress	0
The food was bland oily.	food	-1
What is even better, is that the prices are very affordable as well, and the food is really good.	prices	1
The fish is fresh but the variety of fish is nothing out of ordinary.	fish	1
And Kruno, the beverage manager is the best bartender I have yet to come across.	beverage manager	1
Ambiance and music funky, which I enjoy.	Ambiance	1
The food, drinks and service are clearly among the best in the city.	food	1
I went there in late afternoon for some bite size food and refleshment with my date.	food	0
I understand the area and folks you need not come here for the romantic, alluring ambiance or the five star service featuring a sommlier and a complicated maze of captain and back waiters - you come for the authentic foods, the tastes, the experiance.	ambiance	1
Last time I went here, the waitress didn't come back after taking our order.	waitress	-1
Try the tandoori salmon!	tandoori salmon	1
Eating in, the atmosphere saves it, but at your desk, it's a very disappointing experience.	atmosphere	1
Granted the space is smaller than most, it is the best service you will find in even the largest of restaurants.	space	1
I love the atmorphere @ peep!	atmorphere	1
The service was attentive and her suggestions of menu items was right on the mark.	service	1
The other night we had the $30 three course meal and everything was delicious - if I could of licked the plate clean I would of.	three course meal	1
Even after getting pushed out by the no-class Famous Ray's, Sal has risen again to carry on his father's uncle's legacies with a smile, true love for his community, and let's not forget the Outstanding Pizza!	Pizza	1
The environment is romantic, but the food is horrible, the service is pathetic, and gabriella lies about everything she could.	environment	1
We had crawfish boiled and despite making a mess, it was a ton of fun and quite tasty as well.	crawfish boiled	1
I had very high expectations for this place and made a reservation a couple of months in advance for a special occasion.	reservation	0
What came to our table was burned beyond recognition and stringy.	table	0
So I've never actually been to M proper, but I've had it delivered a few times.	delivered	0
Among all of the new 5th avenue restaurants, this offers by far one of the best values for your money.	values for your money	1
Frankly, when you compare what you can have here for lunch, versus McDs or so many other sandwich shops in the city, there is no comparison.	lunch	1
The hostess is rude to the point of being offensive.	hostess	-1
If you're craving for Haru's great food, especially the House Roll, but can't stand the wait building outisde, head across the street to their Sake Bar!	food	1
A narrow corridor leads to a tiny space where there are three tiny white tiled counters, a great deal of mess (stacks of bottles, cans) and a small counter holding 12-14 entrees.	corridor	0
The food is great.	food	1
Succulent steaks cooked precisely to your desired 'doneness' accompanied by salads and sides that don't look like leafy road kill.	steaks	1
Lunch came with pickels and slaw, no extra charge.	Lunch	1
Decent wine at reasonable prices.	wine	1
All conveniently delivered right to the door.	delivered	1
even the wine by the glass was good.	wine by the glass	1
would have rather tried terrace in the sky or water club for that price	price	-1
This dish is my favorite and I always get it when I go there and never get tired of it.	dish	1
I also ordered the Change Mojito, which was out of this world.	Change Mojito	1
The only thing more wonderful than the food (which is exceptional) is the service.	food	1
The food was just awful, ATROCIOUS actually.	food	-1
The soup for the udon was soy sauce and water.	soup for the udon	0
The anti-pasta was excellent, especially the calamari, as were the filling pasta mains.	anti-pasta	1
They might be all business at the counter when you give your order, but their food says I love you.	counter	1
We are very particular about sushi and were both please with every choice which included: ceviche mix (special), crab dumplings, assorted sashimi, sushi and rolls, two types of sake, and the banana tempura.	sushi	1
Try their plain pizza with fresh garlic or eggplant.	plain pizza	1
Ok, so the servers wander around a little clueless, but there's more than enough servers for the crowd they get -- it's fine, you just have to make a small effort to get their attention.	servers	-1
Good luck getting a table.	getting a table	-1
The service is awful.	service	-1
The takeout menu says to keep an eye out for an expanded menu offering more italian dishes, I can't wait!	takeout menu	1
I am not the most experienced person when it comes to Thai food, but my friend who took me there is.	Thai food	0
Regardless of whether there are two people or two hundred people ahead of you the hostess will take your name and tell you Five minutes.	hostess	1
The pizza is good though.	pizza	1
bottles of wine are cheap and good.	bottles of wine	1
The have over 100 different beers to offer thier guest so that made my husband very happy and the food was delicious, if I must recommend a dish it must be the pumkin tortelini.	beers	1
They didn't give us the dinner special until we asked for it.	dinner special	-1
You must have the crabmeat lasagna which is out of this world and the chocolate bread pudding for dessert.	crabmeat lasagna	1
word of advice, save room for pasta dishes and never leave until you've had the tiramisu.	pasta dishes	1
Very good service and very good prices.	service	1
I recently went to this restaurant with some co-workers for lunch and had an amazing time.	lunch	0
Ess-A-Bagel (either by Sty-town or midtown) is by far the best bagel in NY.	bagel	1
Our food was great too!	food	1
The most annoying thing, though, is the fact that the servers seem to be trained to drive revenue.	servers	-1
Get your food to go, find a bench, and kick back with a plate of dumplings.	food	1
Please try the Filet Mignon, its just the most tender piece ever.	Filet Mignon	1
We were still sitting at the bar while we drank the sangria, but facing away from the bar when we turned back around, the $2 was gone the people next to us said the bartender took it.	bar	0
The sake menu should not be overlooked!	sake menu	1
the drinks are amazing and half off till 8pm.	drinks	1
i've been back to nha trang literally a hundred times for the beef cubes - they're that good.	beef cubes	1
The service, wine selection, ambiance are all outstanding and deserve recognition.	service	1
We were seated promptly as we had reservations, however after that the service was slow.	reservations	1
It's really also the service, is good and the waiters are friendly.	service	1
The food was pretty good, but a little flavorless and the portions very small, including dessert.	portions	-1
It is set far from the small street it's on, and there is no traffic noise.	traffic noise	1
Lived in Shanghai most of my life and thought the food was comparable to the flagship Green Bo restaurant there.	food	1
I highly recommend Cafe St. Bart's for their food, the ambience and wonderful service.	food	1
This is a nice restaurant if you are looking for a good place to host an intimate dinner meeting with business associates.	dinner meeting	0
All the NYU students love this place so it makes for a fun young atmosphere.	atmosphere	1
The food here does a great service to the name (Cantonese that is...).	food	1
But, nothing stands out about the cooking.	cooking	0
Joya used to be a cool spot with decent food and a colorful - if not relaxed - atmosphere.	food	1
The Prix Fixe menu is worth every penny and you get more than enough (both in quantity AND quality).	Prix Fixe menu	1
I've been here 3 times for lunch and it is one of my favorites in the city.	lunch	0
I had their eggs benedict for brunch, which were the worst in my entire life, I tried removing the hollondaise sauce completely that was how failed it was.	eggs benedict	0
I work near-by, and they have the BEST oatmeal in the neighborhood- not a packaged or quick-cooked item.	oatmeal	1
Too bad the food wasn't of the same heritage.	food	-1
The menu looked good, except for offering the Chilean Sea Bass, but the server does not offer up the specials that were written on the board outside.	menu	1
The food was really good, I had the onion soup and it was one of the best ever.	food	1
overall, a solid restaurant and at less than $40pp (including wine), a solid deal as well.	wine	0
Since it literally is a complete hole in the wall, it's a bit intimidating at first, but you get over that very quickly as soon as the friendly staff welcomes you - don't hesitate to ask for help with what to get.	staff	1
Based on the reviews for dinner, this is a place I would reconsider revisiting for that, but definitely not for Dim Sum again.	dinner	1
It costs $2 extra to turn a regular roll into an inside-out roll, but the roll more than triples in size, and that's not just from the rice.	roll	0
When he finally did, he was unable to make a gin and tonic -- couldn't find tonic.	gin and tonic	0
The dim sum is ok but doesn't taste that fresh, and the little dishes don't look steamy hot as they should (also note lack of Chinese here).	dim sum	-1
The service is ok, some of the people didn't get what they asked for.	service	0
If you want good authentic Thai this place is not the place to go.	Thai	-1
I recommend getting a reservation even though we saw people seated without one.	reservation	0
If you want some roast duck, pork or chicken on rice with ginger, try them out!	roast duck	1
You order from a menu, so you leave feeling like you missed the full experience.	menu	-1
Staff is very accomodating.	Staff	1
I went to Del Frisco's Friday night with my boyfriend for an 8:00 reservation.	reservation	0
yourself a favor and have dinner here and see if you dont agree with me.	dinner	0
Very popular style Izakaya (Sake and small portion of sake-friendly dishes ).	Sake	1
The food was terrific and the service classy, attentive, without being overbearing.	food	1
This is an amazing place to try some roti rolls.	roti rolls	1
Fresh ingredients and everything is made to order.	ingredients	1
We have never had any problems with charging the meal or the tip, and the food was delivered quickly, but we live only a few minutes walk from them.	meal	1
Quick and friendly service.	service	1
Try the hot dogs too, they're snappy and delicious.	hot dogs	1
The noise level was unbearable, conversation impossible.	noise level	-1
Personal pans are the perfect size for those hungry nights.	Personal pans	1
Highly recommended is the Spicy Fried Clam Rolls and Spider Rolls.	Spicy Fried Clam Rolls	1
One of the earlier people commenting on the restaurant did not get the that some experimenting is going on with the menu in a positive way.	menu	1
The atmosphere is great if your looking for a laid back scene and an inexpensive way to spend a weekend afternoon.	atmosphere	1
Odd for Ave B, not just odd, The place attracts an eclectic crowd to say the least.	place	1
Instead of wasting your time here: SUPPORT RESTAURANTS THAT CARE ABOUT FOOD.	FOOD	0
head and shoulders above its neighboors on east 6 st, taj mahal is also very comparable, in food quality, to the much overpraised (and underdeserving) baluchi's.	food quality	1
The man that was hosting promised to save a table for our party of 7, then sat a party of 2 at the very table he was saving (mean while there were boths open all around).	man	0
As we were sitting eating the subpar food the manager proceeded to berate a couple of his employees for putting out the wrong containers for condiments and explained to them how expensive these containers were.	food	0
Great Indian food and the service is incredible.	Indian food	1
Decor is nice and minimalist, food simple yet very well presented and cooked, and the wine list matches the food very well.	Decor	1
I had the salmon dish and while it was fine, for the price paid, I expected it to have some type of flavor.	price	0
We ordered a tuna melt - it came with out cheese which just made it a tuna sandwich.	tuna melt	0
Especially liked chicken tikka and the naan, and the dals.	chicken tikka	1
The waiters were not attentive except that the bill turned up on the table before we were finished.	waiters	-1
The restaurant looks out over beautiful green lawns to the Hudson River and the Statue of Liberty.	lawns	1
The sangria was pretty tasty and good on a hot muggy day.	sangria	1
Don't eat here unless you're starving for thai food and you work next door.	thai food	-1
For the people who want great food plus great service, Roxy is a place to AVOID!	food	-1
I had the best ravioli ever.	ravioli	1
Ive been here a bunch of times now and the service is always outstanding.	service	1
The bill is approximately $25 for 2 at lunch without drinks.	bill	0
Quite frankly, this is some of the worst sushi I have ever tried.	sushi	-1
The food is great, service is ok.	food	1
The overall price tag was very very expensive, something I did expect.	price tag	-1
Spice is great Thai food, love the inexpensive appetizers.	Thai food	1
He not only makes his own homemade mozzarella, but every pie is ultra fresh.	mozzarella	1
Fish was overdone.	Fish	-1
When you're sitting in their main dining room (which has a spectacular, hand-painted high ceiling) you'd never know there was a world outside.	main dining room	1
also make sure you pay attention to the music being piped in - quite a weird selection.	music	0
The establishment scores big points in presentation and style.	establishment	1
Good food.	food	1
The wait staff is very friendly, if not overly efficient.	wait staff	1
The dim sum however was very good.	dim sum	1
Service has always been friendly and efficient.	Service	1
Went there and had a combination of different seafood dishes and appetizers.	seafood dishes	0
Its a great place for a casual date or to entertain clients for lunch.	lunch	0
All we received was an apology as we left to see our show without dinner.	dinner	0
The table next to us asked if he crushed the grapes himself when their long overdue bottle of wine finally arrived.	grapes	0
Prices are very good.	Prices	1
We could not catch our waiter's eye, and he ignored us.	waiter	-1
Plain and simple it's bad thai food.	thai food	-1
Usually 3 vs. 4 items per dish.	dish	0
While certain staples are excellent (the burger, some of the pastas), the food is not really the point.	staples	1
The food was so-so.	food	0
The waitress, seems to be more concerned of looking good than actually waitressing.	waitress	-1
The place is larger than most and features adequate seating unlike most joints, and has a bar which deserves a mention.	place	1
Threw my fiance's surprise 30th birthday dinner here couldn't be happier.	dinner	0
Food-awesome.	Food	1
good music, great food, speedy service affordable prices.	music	1
The sides were ok and incredibly salty.	sides	-1
For some reason, all the seafood on the menu was unavailable except for the Salmon.	seafood	0
The beverages were excellent, and the dessert was good.	beverages	1
Next time, we wouldn't dare ordering anything else other than some simple Asian appetizers and drinks.	Asian appetizers	1
Please if your thinking about it go, and stay the wait you won't be disappointed.	wait	-1
I must say the view of NYC is so beautiful!	view	1
If you'd like to have a nice light meal with an asian accent, Long Tan is a good place on the slope.	meal	1
When going out for a nice dinner, I like a nice ambiance as well as very good food.	dinner	1
Otherwise, this place has great service and prices and a nice friendly atmosphere.	service	1
Highly recommend this as great value for excellent sushi and service.	value	1
This place would be so much better served by being run by a group that actually understands customer service.	served	-1
A++   The service was good to excellent along with the attitude.	service	1
The food is awesome - definitely try the striped bass.	food	1
The music does get a little loud at times, but it just made me want to lean closer to my beautiful wife, and as I did, I got a whiff of corriander.	corriander	0
It's simply the best meal in NYC.	meal	1
After passing by this restaurant for sometime I finally decided to go in and have dinner.	dinner	0
The seating was if they were trying to get the maximum amount of people into the restaurant, so be nice to your neighbor when you dine here.	seating	-1
We go on Mondays for the prix fixe and our experience with the food has been comparable to Blue Ribbon.	prix fixe	0
However, they've got the most amazing pastrami and the soups hit the spot.	pastrami	1
Great bagels made the old-fashioned way.	bagels	1
This is some really good, inexpensive sushi.	sushi	1
my personal favorite is an everything bagel with lox spread, but all the bagles are unbeliavably good.	bagel with lox spread	1
I wouldn't even have complained at all if the food at least tasted good but the quality of food was crappy, too.	food	-1
For the next hour and a half we stood in the crowded lobby area of this touristy restaurant listening to all types of explanations of why we were not being seated.	lobby area	-1
The pizza is delicious and the proprietor is one of the nicest in NYC.	pizza	1
Also good for client lunch meetings, esp.	lunch meetings	0
The decor is dark, cool and soothing, while the food's presentation is spectacular, considering the low prices.	decor	1
The Waitstaff were very nice and suggested swordfish for my husband he enjoyed his meal.	Waitstaff	1
The setting is casual and romantic.	setting	1
Terrible, terrible management - deserves to be shut-down.	management	-1
Great friendly service, Fast seating, Fast Delivery, Excellent sushi.	service	1
The desserts are more appealing then stuffy overpriced French restaurants.	desserts	1
The Italian food has flavor (that can be sort of surprising on the UES), and the service turns from a nightmare to attentive,they sort of remind me of the NY Yankees of the late 90's, no matter how bad it look, you knew that there was a rally just around the corner...	Italian food	1
I found the food to be outstanding, particulary the salmon dish I had.	food	1
Mizu is home to creative and unique rolls not to found anywhere else.	rolls	1
Baluchi's has solid food and a nice decor at reasonable prices.	food	1
Emilio, the owner, is often sitting in the front table greeting guests as they come and go.	owner	1
I have been to spice three times- twice during lunch and once at dinner.	lunch	0
A cheap eat for NYC, but not for dosa.	eat	1
The atmosphere is noisy and the waiters are literally walking around doing things as fast as they can.	atmosphere	-1
The seafood is amazing, there's a good wine list, and the ever-changing menu always offers some great surprises.	seafood	1
i don't usually order wine with indian so i can't comment on their wine list or their wines.	wine	0
Pastrami or corned beef are juicy and piled high (ask for extra rye bread).	Pastrami or corned beef	1
($200 for 2 glasses of champagne, not too expensive bottle of wine and 2 after dinner drinks).	glasses of champagne	-1
Really though, where's the seasoning?	seasoning	-1
The food was just OK, at least for what food was available.	food	0
The waitress was very patient with us and the food is phenomenal!	waitress	1
The ambience was nice, but service wasn't so great.	ambience	1
Solid wine list, knowledgeable staff, friendly owners and an adventurous, ever-changing menu keep us coming back.	wine list	1
We didn't even see a menu, as our waiter described both the specials and the main dishes.	menu	1
otherwise, good stuff for late nite eats.	stuff	1
The dinner was ok, nothing I would have again.	dinner	-1
I love and I know gourmet food by excellence!	gourmet food	1
I plan to come here again and look forward to trying their assortment of bruschetta, panini's.....	bruschetta	1
Two people in our party felt like something else, and Volare immediately obliged with two great dishes that were not in their regular menu.	dishes	1
He offers subpar service and has no personality.	service	-1
The waitress remembers me and is very friendly, she knows what my regular is and that's the fried mini buns with the condensed milk and the assorted fruits on beancurd.	waitress	1
Diner food at bistro prices is a bummer....	food	-1
While we thoroughly enjoyed the food, it was annoying to scream across the table for conversation.	food	1
The portions are large and the servers always surprise us with a different starter.	portions	1
delicious bagels, especially when right out of the oven.	bagels	1
All the food was hot tasty.	food	1
This is one great place to eat pizza more out but not a good place for take-out pizza.	pizza	1
Our server was very helpful and friendly.	server	1
Try green curry with vegetables.	green curry with vegetables	1
First of all, this place is *not* romantic, as claimed by Citysearch's editorial review.	place	-1
The second you walk through the heavy vault like door, with people anticipating your arrival you get the sense that you are going to have the dining ride of a lifetime.	door	0
Much more reasonably priced too!	priced	1
Why make a reservation if you aren't going to keep it?	reservation	-1
The Pad Thai is excellent here, as well.	Pad Thai	1
I do not recommend lunch specials just because it tasts the same with other regular chinese restaurant.	lunch specials	-1
We parked on the block of Nina's the place looked nice, with people obviously enjoying their pizzas.	place	1
The food is o.k., but not any better than what you get at a good neighborhood restaurant.	food	0
We had the pot-stickers which were great and a tempura dish that was great.	pot-stickers	1
I think the stuff was better than Disney.	stuff	1
While the $20 entree range is not overly expensive, in New York City, there is definitely better food in that range, and so Sapphire, despite it's lovely atmosphere, will most likely not be a restaurant to which I will return.	entree range	1
Orsay, is without a doubt one of the best values for authentic French food in NYC.	French food	1
Well, their deliveries take for ever and the food is usually cold.	deliveries	-1
The staff is no nonsense.	staff	1
And really large portions.	portions	1
This is a great Thai restaurant with a very friendly staff.	staff	1
I ordered the smoked salmon and roe appetizer and it was off flavor.	smoked salmon and roe appetizer	-1
We went here for lunch a couple of weeks ago on a Saturday, and I was thoroughly impressed with the food.	lunch	1
I recommend the garlic shrimp, okra (bindi), and anything with lamb.	garlic shrimp	1
As we were leaving, the couple standing by the door said to another waiter, we're not in a hurry.	waiter	0
The menu was impressive with selections ranging from a burger, to steak, to escargot.	menu	1
In fact, two people could really share one plate.	plate	1
Good for casual dinner with jeans and sneakers.	casual dinner	1
Anyway, the food is good, the price is right and they have a decent wine list.	food	1
Prices are higher to dine in and their chicken tikka marsala is quite good.	Prices	1
This place has many different styles of pizza and they are all amazing.	styles of pizza	1
The photos of the restaurant in its web site are way better than the real look.	look	-1
The food was lousy - too sweet or too salty and the portions tiny.	food	-1
But the coconut rice was good.	coconut rice	1
It took them 25 minutes to bring our appetizer.	appetizer	0
The food was great.	food	1
Pair you food with the excellent beers on tap or their well priced wine list.	food	1
If you like your music blasted and the system isnt that great and if you want to pay at least 100 dollar bottle minimun then you'll love it here.	music	-1
All of my co-workers stated that the food was amazing and wondered why they hadn't heard about this place.	food	1
Metrazur has a beautiful spot overlooking the main terminal.	spot	1
Friendly staff that actually lets you enjoy your meal and the company you're with.	staff	1
The restaurant is rather small but we were lucky to get a table quickly.	table	1
Quality of food is excellent and price is cheap, stick to pork, fish, chicken, lamb and vegetables.	Quality of food	1
The place is a little tight and on a cold day, the seating by the entranceway can be pretty drafty.	place	-1
The appetizing is excellent - just as good as Zabars Barney Greengrass at a reasonable price (if bought by the pound).	appetizing	1
But, they were too big for the bun.	bun	0
The food is fresh, delicious, and reasonably priced.	food	1
Raga stands out with an interesting fusion of French and Indian cooking.	fusion of French and Indian cooking	1
The bagels are fabulous.	bagels	1
Oh yes, and they lie on the phone, claiming they have seating in the garden, then of course the seats are not available.	seating in the garden	0
The food was very good, a great deal, and the place its self was great.	food	1
The food options rule.	food options	1
A great choice at any cost and a great deal.	cost	1
We ate here in March, 2006 and ordered the pre-theatre 3-course dinner with wine flight.	pre-theatre 3-course dinner	0
Probably much busier for lunch, it's seldom crowded for dinner (too close to downtown).	lunch	0
Their calzones are horrific, bad, vomit-inducing, YUCK.	calzones	-1
It takes forever to get a drink and they almost always forget to bring something (although they dont forget to charge you for it.	drink	0
Saturday, Nov. 6th I had a group from work come in with about 35 people and the staff was amazing to accomodate us.	staff	1
Good spreads, great beverage selections and bagels really tasty.	spreads	1
First, the waiter who served us neglected to fill us in on the specials, which I would have chosen had I known about them.	waiter	1
Also, top the meal with a delicious and perfect slice of tiramisu.	meal	1
Check out the secret back room.	secret back room	1
It's also attached to Angel's Share, which is a cool, more romantic bar...	bar	1
Stick to the gulab jamun.	gulab jamun	1
I was back-to-back with the diner at the table behind me and wait staff had to hoist trays over our heads as they squeezed past us again and again.	diner	0
With the theater 2 blocks away we had a delicious meal in a beautiful room.	meal	1
By far this is the only chinese desserts place I know in NY or anywhere close in the Northeastern America that serves desserts with frog jelly in a couple of varieties and pig feet ginger simmered in black vinegar.	desserts with frog jelly	1
The food is great and reasonably priced.	food	1
I would definitely recommend SEA if you like thai cuisine!	thai cuisine	1
Over the years the host, Vittorio, and his crew, have always treated me as family--although with all the business this not-so-little gem does, it amazing he's even able to remember a consistent but not-so-frequent visitor.	host	1
The restuarant itself is not large, but seems to have several round tables to accomodate large groups hoping to save a buck to eat authentic Taiwanese.	round tables	1
My husband said he could've eaten several more, the portion was fine for me he even exclaimed that the french fries were the best he has had.	french fries	1
It is the type of place to run into old friends and have a late, raucus dinner.	dinner	1
The food is delicious - from the specials to the regular menu-fare, the dishes are never a disappointment.	food	1
Prices are in line.	Prices	0
The combination of fresh tomato sauce, fresh mozz cheese, basil and the dough they make with imported flour, makes this is one of the better pizza's in NY.	fresh tomato sauce	1
The food is prepared quickly and efficiently.	food	1
The food looked very appetizing and delicious since it came on a variety of fancy plates.	food	1
The food is terrible and overall, I would have to say avoid at all costs.	food	-1
Unfortunately, the food was NOT something to get worked up about.	food	-1
It's constantly open, catering to the Pakistani cabbies lined up on Crosby St., so there's more turnover with the food than you'd expect (i.e., surprisingly fresh).	food	1
I had Filet Mignon with garlic mash.	Filet Mignon with garlic mash	0
I went at 6:00 PM specifically for the pre-theater menu ($19.95 for roasted tomato soup with chevre, steak frites, creme brulee) and it was marvelous.	pre-theater menu	1
The waitstaff were attentive, polite and helpful - an impressive feat in such close quarters.	waitstaff	1
- the bread at the beginning is super tasty and makes you want more - the pizza is delicious and comes in personal sizes, however be warned that the Peter's Favourite pizza with prosciutto and baby arugula is actually a margarite pizza with cold prosciutto and baby arugula on top, like a salad.	bread	1
The large selection of bruschettas, paninis, tramezzinis keep the palate from stagnating.	bruschettas	1
Have always found that the waiters will go out of their way to be helpful, despite the fact they are often busy with lots of diners.	waiters	1
While this isn't classical restaurant fare, the chef has given new life to an old cuisine with some really innovative and tasty dishes that are genuinely Indian without being heavy or same old restaurant burn-outs.	chef	1
The owner truly caters to all your needs.	owner	1
He takes real pride in his food and his business.	food	1
So if you want a nice, enjoyable meal at Montparnasse, go early for the pre-theater prix-fixe.	meal	1
Over the years, it has always provided a pleasurable dining experience with quality food and wine.	dining	1
The photobook menu was a cute touch, certainly helped my group and I pick the fried chicken, pork chop, and noodle dishes that we all ordered.	menu	1
I cannot imagine better Indian food in all of the city.	Indian food	1
Great romantic place for a date (try to get the corner booth table for a little privacy and to sit close!).	place	1
I asked for an open faced cheese sandwich and the manager basically told me to take my business elsewhere!	open faced cheese sandwich	0
very good breads as well.	breads	1
if this happens, just ask for real naan.	naan	0
We were fans of the half-price Saturday night option until some inedible squid during a recent visit.	half-price Saturday night option	1
Pizza is terrific, as is homemade pasta.	Pizza	1
This is a wonderful place on all stand points especially value ofr money.	value ofr money	1
Example is the soup which was about 6 oz for $12 dollars and the mushrooms where $12 for about 1oz.	soup	1
There are other people waiting!	waiting	-1
From beginning appetizers, the scallops were incredible, to the delicious chocolate souffle with rasberry mint sorbet, we were delighted by the taste sensations.	beginning appetizers	1
Consistently good Japanese Tapas.	Japanese Tapas	1
The dishes offered were unique, very tasty and fresh from the lamb sausages, sardines with biscuits, large whole shrimp to the amazing pistachio ice cream (the best and freshest I've ever had).	dishes	1
The food is reliable and the price is moderate.	food	1
The server was really cool and served us our food and drinks with a smile.	server	1
We were in search of food and stumbled on this block of Indian restaurants on East Sixth Street.	food	0
Planet Thailand has always been a hit with me , I go there usually for the sushi, which is great , the thai food is excellent too .	sushi	1
Very excited to hear that short-term Chef Jason Narone has moved on, he truly was a low point of their Sterling track record.	Chef	-1
I had to share my table with a loud group of kids and the service was rude an unattentive.	table	-1
The sauce on the pizza is sooo good with garlic and fresh tomatoes and they don't skimp.	sauce on the pizza	1
We recently decided to try this location, and to our delight, they have outdoor seating, perfect since I had my yorkie with me.	outdoor seating	1
My husband had the mesclun, salmon, and ice cream and he enjoyed all 3 courses.	mesclun	1
We were told that the wait was about twenty minutes and there would be no problem for our 8:00 pm curtain call.	wait	0
The food is usually good but it certainly isn't a relaxing place to go.	food	1
Super friendly and knowledgable staff, fabulous bistro fare and a wonderful jazz brunch with great live jazz (the chilaquiles were awesome!	staff	1
The prices were fantastic.	prices	1
Still, any quibbles about the bill were off-set by the pour-your-own measures of liquers which were courtesey of the house...	measures of liquers	1
The table service could have been a little more attentive but as someone who also works in the service industry, I understood they were busy.	service	0
It's not mind-blowing, but to me, thai food never is and never will be.	thai food	0
Food was very good as well, considering that we tried the budget selection (though I wish the pork belly that I ordered was roasted a bit longer, so that fat was more of a melt-in-your-mouth experience).	Food	1
It is kinda nosiy and the tables are close together but it's still a beautiful place to enjoy a nice dinner.	tables	1
I love the fact that the pizza tastes so good and is so cheap.	pizza	1
Nicky the Nose at the bar is a treat.	bar	0
Service was prompt, friendly and great.	Service	1
I haven't eat a lamb chop as delicious as that,the salads are really nice dressed with lemon and extra virgnin olive oil.	lamb chop	1
The sushi was awful!	sushi	-1
You can get an excellent meal at most of the many Indian restaurants on nearby Lexington Avenue for the cost of one the dainty dishes here.	meal	1
The Pastrami sandwich was like buttah and with pickles and an icy cold beer to wash it down, it was a pleasurable experience.	Pastrami sandwich	1
Late nite omelletes are not good here, there is no variety!	omelletes	-1
After all that, they complained to me about the small tip.	tip	-1
It's a great place to pick up a cheap lunch or dinner.	lunch	1
Behind this counter, two men are squeezed in.	counter	-1
Whenever you need a Sushi fix, Mizu will be there with quality fish and great service.	Sushi fix	1
Our waitress was sweet and accomodating, not overbearing.	waitress	1
I was really disappointed ant wanted to tell everyone not to go eat or even take out food from there.	food	-1
Despite a slightly limited menu, everything prepared is done to perfection, ultra fresh and a work of food art.	menu	1
The outdoor atmosphere of sitting on the sidewalk watching the world go by 50 feet away on 6th avenue on a cool evening was wonderful.	outdoor atmosphere	1
brick oven gallery is My pick for best pizza restaurant anywhere.	pizza	1
Add to that great service and great food at a reasonable price and you have yourself the beginning of a great evening.	service	1
For many people, this may not seem like Aunthentic Thai food because most places in NYC arent quite authentic.	Thai food	-1
Growing up in NY, I have eaten my share of bagels.	bagels	0
Oh, don't even let me start with how expensive the bills were!	bills	-1
The scallion pancakes and fried dumplings were nothing out of the ordinary.	scallion pancakes	0
All the appetizers and salads were fabulous, the steak was mouth watering and the pasta was delicious!!!	appetizers	1
Besides having the table we had been promised given to other restaurant patrons twice before we were actually seated, we were served dishes we hadn't ordered three times, received one of our orders 20 minutes after the rest of the table had been served (and that order was undercooked), and charged $45 more than we should have been on our bill.	table	-1
Service is top notch.	Service	1
The food now is inconsistent.	food	-1
You can also special order any kind of dumpling,etc.	dumpling	1
I was pretty much full after our fondue appetizer.	fondue appetizer	0
BE CAREFUL before you request extra spice.	spice	0
The octopus eaters were floored by the Octopus salad.	Octopus salad	1
We thought that this place is using too much of MSG cooking in the foods.	MSG cooking	-1
And the Tom Kha soup was pathetic.	Tom Kha soup	-1
I started out with a Bombay beer which was big enough for two.	Bombay beer	1
The decor is vibrant and eye-pleasing with several semi-private boths on the right side of the dining hall, which are great for a date.	decor	1
Drawbacks: service is slow and they don't toast!	service	-1
Went there for an office lunch.	office lunch	0
The sweet lassi was excellent as was the lamb chettinad and the garlic naan but the rasamalai was forgettable.	sweet lassi	1
We've been following chef Lyle's food around New York for 15 years and while remaining classic, his innovations with bistro fare have made us return and return.	chef	1
The best thing I tasted were the lambchops.	lambchops	1
The spicy tuna and salmon are the best we've ever had.	spicy tuna	1
Even though its good seafood, the prices are too high.	seafood	1
In addition, the food is very good and the prices are reasonable.	food	1
Been going here since it opened have seen the quality value decrease considerably.	quality value	-1
they bring service up a notch by offerng complementary amuse bouche to all tables and gave us a small dessert for our celebration.	service	1
Try the crunchy tuna, it is to die for.	crunchy tuna	1
It won't break the bank but I also wouldnt come back for the food.	food	-1
All in all, this midtown gem instantly became one of my favorite sushi restaurants in the city.	sushi	1
It is a lot of fun with live entertainment and all kinds of Disney type special effects.	live entertainment	1
if you're looking for perfect traditional sushi, go here - if you're looking for interesting combinations, try sushi of gari's (east side).	sushi	1
No refills on fountain drinks, though.	fountain drinks	-1
Wow over 100 beers to choose from.	beers	1
Be careful of portions - they're HUGE.	portions	1
The Steak Tartare is a great bet, they fix it for you at the table.	Steak Tartare	1
My first time there I happened not to like the Crab Croquette apt that i ordered and they were happy to change it for me without making no big deal.	Crab Croquette apt	-1
Great for large groups and celebrations - our SUPER HAPPY waiter was the entertainment of the evening.	waiter	1
Did I mention the wine?	wine	0
Plus, on Wednesday nights the house wine is unlimited!	house wine	1
However, in the summer of 2003, it seems the management has changed and the great big door has been replaced for a glass front ridding itself of the dark romantic getup.	management	1
We won't go to this place again for a good meal.	meal	-1
Barbecued codfish was gorgeously moist - as if poached - yet the fabulous texture was let down by curiously bland seasoning - a spice rub might have overwhelmed, however herb mix or other sauce would have done much to enhance.	Barbecued codfish	1
After dinner, take your date to the HUGE dance floor, probably one of the biggest you'll see in NY.	dinner	1
Taj Mahal offeres gret value and great food.	value	1
Has the chef and owner changed???	chef	0
My boyfriend and I recently had an early dinner at Artisanal and was satisfied with our experience.	dinner	1
But don't ever order bacon late at nite (either platter or in sandwiches, for that matter don't from any take out place) as it is from the morning frying turns out hard almost like bacos, hurt my molars.	bacon	-1
Outstanding Bagels, but you get what you pay for.	Bagels	1
Pizza - the only pizza in NYC that should not have additional toppings - the crust tastes like the best, freshly baked bread!	Pizza	1
I found it on a cold night, the perfect spot to warm up.	spot	1
They even have a section in the menu called American Chinese food!	menu	-1
Service was warm and attentive, beef carpaachio was exellent (huge portion) and pasta was fresh and well-prepared.	Service	1
kalbi and nebbiolo do work together.	kalbi	0
Best Italian food I ever had (and being Italian, that means alot).	Italian food	1
I will recommend Scopa to all of my friends for a place to go for wonderful Italian food.	Italian food	1
Located at the end of a magnificent block.	Located	1
Looking around, I saw a room full of New Yorkers enjoying a real meal in a real restaurant, not a clubhouse of the fabulous trying to be seen.	room	1
They don't walk around with the trays of Dim Sum.	trays of Dim Sum	0
Great bar, most gorgeous bartenders you've ever seen (specifically the blond lady).	bar	1
We were planning to get dessert but the waitress basically through the bill at us before we had a chance to order.	dessert	0
I really loved the different and inovated touch that's the cheff gives to the food.	cheff	1
They came out over cooked and the cheese was almost non existant.	cheese	-1
I had a terrific meal, and our server guided us toward a very nice wine in our price range, instead of allowing us to purchase a similarly priced wine that wasn't as good.	meal	1
The svc can be a bit rude at times, esp if you have big group, but overall the restaurant is a must!	svc	-1
The food is good, especially their more basic dishes, and the drinks are delicious.	food	1
But the main hit was the whole grilled fish.	whole grilled fish	1
I had the tuna tartare with sake, mushroom ravioli with pinot noir, and the chocolate sampler with a dessert wine for $49.	tuna tartare	1
The food is delicious and beautifully prepared along with the friendly and personable service.	food	1
I usually go there later at night when I get off work so I don't have to deal with crowds or lines.	crowds	-1
Pizza here is consistently good.	Pizza	1
We had a great tiem watching the shows and characters and ar food was just what we were looking for.	shows	1
After 2 tries by the waiter to take it away (we hadn't even looked at it yet, we had full beers yet to drink), the manager approached and told us they needed the table for people with reservations.	waiter	1
Wouldn't recomend it for dinner!	dinner	-1
Sauce was watery and the food didn't have much flavor.	Sauce	-1
My husband and I enjoy Sangria.	Sangria	1
But after last night, Spice Grill is the only place I'm eating indian cuisine.	indian cuisine	1
We both opted for a pasta dish and they were served timely and fresh.	pasta dish	1
First the wrong bread came out with the appetizer, then when i tried to order a second glass of wine for my main course...	bread	0
Not sure where the previous reviewer, lonk, dined, but Saul is in a great neighborhood and has great food!	neighborhood	1
In an area sadly lacking in decent Thai food, this is one of the best spots.	Thai food	1
Tell them Herky sent you and get a free confused look from the waiter.	waiter	-1
Make reservations but expect to be delayed 15-20 minutes as the hosting staff was having difficulty seating guests who arrived with a reservation because they probably had a lot of walk ins being so close to Time Square.	reservations	0
The food was average or above including some surprising tasty dishes.	food	1
They don't seem to place an emphasis on specials or fresh ingredients which to me is necessary for good thai.	specials	0
Other apetizers and food	apetizers	0
The noodle and rices dishes taste great.	noodle and rices dishes	1
The crust is thin, the ingredients are fresh and the staff is friendly.	crust	1
Also a little more expensive than your average bagel place.	bagel	0
the food was undercooked-the sauce watery, and the vegetables raw.	food	-1
And the fried clams had just enough kick to them to make 'em worth eating.	fried clams	1
The sauces used are also not that exciting.	sauces	-1
The secret is the lunch menu which offers a complimentary appetizer with every entree ordered.	lunch menu	1
The rice was poor quality and was cooked so badly it was hard.	rice	-1
When my dessert came, there was a candle in it - not because anyone asked for one - but because the waiter must have seen me opening my birthday card and gift, and said he knew it was a special occassion of some sort.	dessert	1
I got the $10 10-piece dim sum combo, every bite of which was great.	dim sum combo	1
There is also very limited seating and there can be a substantial wait in getting food at peak times.	seating	0
If it's just a quick martini at the bar (which I recommend Jeffery's) or a mind blowing Roast Chicken, go to Village!	martini	1
There was a long wait for a table outside, but it was a little too hot in the sun anyway so our insde table was very nice.	wait	0
The prices are wonderfully low.	prices	1
If you like spicy food get the chicken vindaloo.	spicy food	0
I have never been disappointed but their true strength lays in their amazingly delicious and cheap lunch specials.	lunch specials	1
So much more than the usual bar food, go there to enjoy the menu while sampling one of their hand-crafted beers.	bar food	1
No free drink.	drink	0
This is my first time writing a review for a restaurant because the food and service was excellent.	food	1
While they keep the capex to a minimum, they do put some cash into the bagels, because they among the best in the city.	capex	1
The two star chefs left quite some time ago to open their own place.	chefs	0
Don't waste money on decor.	decor	0
They also have a back garden open in the summer - cute and French with outdoor seating - what more could you ask for?	back garden	1
I have never before eaten 40 pieces of relatively good nigiri.	nigiri	0
Given the incredible architecture surrounding it, this place has no character.	architecture	1
I'd call it an 'italian dinner'.	dinner	0
While the place is not a hotspot hangout, the drinks are unique and pack a lot of bang for the buck.	place	1
Have frequented 'ino for several years and the food remains excellent.	food	1
Their eggplant is so delicate, sweet tender!	eggplant	1
Each bite of food at Kai was indeed delicious, fresh, and elegant.	food	1
all the food was excellent - considering the quality of food in most moderately priced restaurants is mediocre this was slightly more pricey and well worth it.	food	1
My friend got the mushroom pizza which tasted better.	mushroom pizza	1
I had the cod with paella (spicy and very filling, I'm a big eater and could only eat half) while my boyfriend had the classic fish and chips (again, a big serving - at least 5 pieces of fish and a basketful of fries).	cod with paella	0
It's a shame that a nice, convenient place like the Pink Pony can be so ruined by lousy service.	place	1
The porcini mushroom pasta special was tasteless, so was the seafood tagliatelle.	porcini mushroom pasta special	-1
Try the spicy wontons and the salt pepper shrimps.	spicy wontons	1
THE FOOD PORTIONS ARE REALLY LARGE.	FOOD PORTIONS	1
The fries are yummy.	fries	1
Friendly and informative staff, very attentive and prompt raw bar service.	staff	1
Best Taiwanese food in NY!	Taiwanese food	1
This place is a great stop for great food.	food	1
All the pastas are fantastic and the homemade lasagna is some of the best that I have had in the City.	pastas	1
We laughed when he finally offered us a dessert menu and we left a 10 percent tip, which was generous, I feel.	dessert menu	1
And the prices were way to high for what you get.	prices	-1
The staff ignored my friends and I the entire time we were there.	staff	-1
Yet paired with such rude service, would never recommend for anyone interested in carrying any kind of conversation while there.	service	-1
The in-house lady DJ on Saturday nights has outrageously good taste in music, and moreover, takes requests.	in-house lady DJ	1
I need at least three rolls to be full, and that's at least $14.00!	rolls	0
The hot dogs were cold in the middle and the buns were stale.	hot dogs	-1
While the food was excellent, it wasn't cheap (though not extremely expensive either).	food	1
Beef noodle soup is good as well.	Beef noodle soup	1
Delivery service is great too.	Delivery service	1
The food's dazzling flavors overwhelm the palate, truly embracing the beauty of authentic Thai cuisine.	food	1
I recieved prompt service with a smile.	service	1
They pray to their Food Gods to make them into a good pizza like VT's.	pizza	-1
The place was quiet and delightful.	place	1
The food is a diamond in rough -- the food is delicious and homemade with the perfect balance of herbs and tomatoes.	food	1
As much as I like the food there, I can't bring myself to go back.	food	1
It looked like shredded cheese partly done - still in strips.	shredded cheese	-1
The prices and ambience are especially great considering it's in the West Village.	prices	1
It is so easy to get a reservation at a top place in NYC with a week's notice.	reservation	1
I have never better enjoyed humble root vegetables or a mushroom consomme - and this chef accomplishes without fats.	root vegetables	1
not the food ,not the ambiance , not the service, I agree with the previous reviews you wait and wait , the wait staff are very rude and when you get in they are looking to get you right out .	food	0
I always get the Shabu-Shabu dinner and the beef is always fresh.	Shabu-Shabu dinner	1
The pizza was delivered cold and the cheese wasn't even fully melted!	pizza	-1
We were very surprised by how good the food was on our first visit here on a Sunday night.	food	1
Nha Trang, while being notorious for utter lack of comfort and decor, horribly slow wait staff and horribly quick meals, is one of the best vietnamese restaurants i've ever been to. the pho is delicious and comes with very fresh vegtables.	comfort	1
On the other hand, if you are not fooled easily, you will find hundreds of restaurants that will give you service and ambiance that is on par with Alain Ducasse, and food that will outshine in presentaion, taste, choice, quality and quantity.	service	0
If I could rate the people this place would be off the charts - unfortunately - the pizza, sorry - not the best in NYC.	people	1
The food is amazing!!!!	food	1
Having not been home in the last 2 years may skew this reviewer a bit, but the food was tasty and spicy sans the oil that comes floating along at similar venues.	food	1
The portions are now very small, the sauces are overly-ambitious usually inedible while the service is still good, the restaurant, due to its popularity, seems frantic.	portions	1
For the price, you cannot eat this well in Manhattan.	price	1
The owner is very friendly and a great guy, go try his pizza, you'll like it!	owner	1
The atmosphere is great!!!	atmosphere	1
With so many good restaurants on the UWS, I don't need overpriced food, absurdly arrogant wait-staff who don't recognize they work at a glorified diner, clumsy service, and management that doesn't care.	food	-1
I tend to judge a sushi restaurant by its sea urchin, which was heavenly at sushi rose.	sea urchin	1
The service is a little scatty at times but all is forgiven when the food arrives.	service	1
The bruscetta is a bit soggy, but the salads were fresh, included a nice mix of greens (not iceberg) all dishes are served piping hot from the kitchen.	bruscetta	1
The atmosphere isn't the greatest , but I suppose that's how they keep the prices down .	atmosphere	1
The pickles were great addition.	pickles	1
If your favorite Chinese food is General Tao chicken, then this is NOT your place.	Chinese food	0
You must try the shrimp appetizers.	shrimp appetizers	1
Not only is the cuisine the best around, the service has always been attentive and charming.	cuisine	1
The production is a symphony, alot of fun to experience.The food sublime for the most part.	food	1
Waiters tend to forget drinks completely, food portions are so tiny, two people have trouble sharing one entree.	Waiters	0
The cold appetizer dishes taste like the way I remember them to taste when I was growing up in Taiwan.	cold appetizer dishes	1
The restaurant was packed at first, so we waited at the bar for about 20 minutes before we were seated.	bar	0
Interesting selection, good wines, service fine, fun decor.	wines	1
Any if you have a reservation you'll wait for max 5 minutes - so have a drink at the bar.	reservation	1
Whether it's the parmesean porcini souffle or the lamb glazed with balsamic vinegar, you will surely be transported to Northern Italy with one bite.	parmesean porcini souffle	1
The food at this place is 'gourmet' Indian cuisine.	food	0
But the thing that my wife and I hated was it was so loud and it felt like 'bar' or 'pub'.	bar	-1
While there are plenty of places to go for a good corned beef sandwich, Katz's has a charm about it.	corned beef sandwich	1
However, looking at the table next to ours, we both sort of wished we had ordered pizza, which looked PERRRRRRRRRFECT.	pizza	1
Priced at upper intermediate range.	Priced	-1
If you live in new york city, you'll find better food at small restaurants outside of time square and spend half the amount.	food	-1
Try the olive cream cheese or the lox spread on a whole wheat everything bagel.	olive cream cheese	1
they didn't disappoint, service from the second i arrived at the door was extremely pleasant and attentive with almost one server per table.	service	1
I don't know who they think they are but they have no respect for the residents of the neighborhood ever since they opened their cabaret next door and blasts loud music till three in the morning every weekend during the summer.	music	-1
The rice to fish ration was also good--they didn't try to overpack the rice.	rice to fish ration	1
They used shredded cheese on top!	shredded cheese	0
The food is great and they have a good selecion of wines at reasonable prices.	food	1
The only positive was the wait staff, which was prompt, knowledgable, and likeable.	wait staff	1
I couldn't reccommend their Godmother pizza any higher.	Godmother pizza	1
I am not a vegetarian but, almost all the dishes were great.	dishes	1
I was very impressed by this low-key upper eastsider and their authentically thai cuisine!!!	thai cuisine	1
For the location, the prices are very reasonable.	location	1
The food is okay and the prices here are mediocre.	food	0
My friend's food was also the complete opposite of what it's supposed to taste like (aND look like).	food	-1
I ordered the crab cocktail and it was soaked in a lime juice concoction where all you could taste was the lime.	crab cocktail	0
I would like to return and try some of the other menu items when I don't have to rush off to a show.	menu items	1
Hopefully next time, I will save room for dessert.	dessert	0
Not a typical pizza joint, but good for a low key and fairly cheap nice sit down dinner.	dinner	1
The corned beef was tender and melted in my mouth.	corned beef	1
The best Chicken pad tai, I've ever had.	Chicken pad tai	1
$20 for all you can eat sushi cannot be beaten.	sushi	0
Haru serves very fresh fish, has a trendy, modern ambiance, prime location on Park Avenue South and friendly service.	fish	1
Warm and friendly in the winter and terrific outdoor seating in the warmer months.	outdoor seating	1
Very romantic fires - I've literally spent hours at Lanterna, drinking wine from their extensive wine and enjoying the ambience.	wine	1
We got a little tipsy from the sake but isn't that what Saturday nights with the girlfriends are all about?	sake	0
Always a nice crowd, but never loud.	crowd	1
My turkey burger was not cooked at all, my friends salmon was completely raw.	turkey burger	-1
Decor is minimalist and clean - nothing to distract or commend.	Decor	0
His drinks are very inventive, delicious and classy.	drinks	1
Great food, great prices, great service.	food	1
This isn't your corner Chinese food takeout.	Chinese food	0
Awsome Pizza especially the Margheritta slice.	Pizza	1
This place, however, has a lot less pretension than Joya and the Thai food is still above-average.	place	1
Try ordering from the regular menu, then you would not regret!	menu	1
Told us to sit anywhere, and when we sat he said the table was reserved.	table	-1
uni from maine vs california, sea vs freshwater eel) to get a good taste comparison.	eel	0
We started with lox and mussels (the best ive ever had, ever) and had the cod and trout for dinner.	lox	1
The crispy chicken wasn't for us, though.	crispy chicken	-1
Food is great.	Food	1
I recommend the meatballs and caprese salad and the beans on toast were a wonderful start to the meal!	meatballs	1
This place is incredibly tiny.	place	-1
I didn't complain, I liked the atmosphere so much.	atmosphere	1
In reality (to maximize potential diners) they were still taking phone reservations and reallocating tables of those waiting in the lobby.	diners	0
The wine is always good, the tapas are always yummy, especially with the warm pita bread.	wine	1
But when you are seated the waitresses are great, they explain everything on the menu, and the price of the food is really cheap for the service you get.	waitresses	1
I've been to several places for Dim Sum and this has got to be the WORST.	Dim Sum	-1
The freshest, best variety, and the fastest delivery.	variety	1
Go to Volare for 1st class service and terrific food.	service	1
It's super-trendy and there's always someone to take that empty seat, so it seems that customer service has been deemed not of the essence.	seat	1
Dinner took almost 4 hours without any lag time.	Dinner	-1
The people in the restaurant were pretty obnoxious and loud.	people	-1
The sandwiches are dry, tasteless and way overpriced.	sandwiches	-1
The fried rice is really good too.	fried rice	1
still stay away, the table next to us walked out after my table and aanother were serves eventhough they were there much longer...	serves	-1
I was with a party of 7 (close but not next the the front doors) and we were eating with our coats on.	front doors	0
A very inviting restaurant, with friendly service.	service	1
THe back garden sitting area is very pleasant, where you can see their personal herb garden.	back garden sitting area	1
Good French restaurant in an area devoid of decent restaurants unless you're into eating 4 pound pastrami sandwiches at Katz' Deli, or Mexican food which is supplied by capable restaurants.	pastrami sandwiches	0
The drinks are always welll made and wine selection is fairly priced.	drinks	1
We also had shared a house salad that was fresh.	house salad	1
The ceiling is amazing!	ceiling	1
And at the conclusion of this culinary nightmare the check was given to our table by knocking over a glass of water.	check	0
Not a small feat for good french food in the area.	french food	1
The space is a bit too small for live music, so on  jazz nights, it can be loud and cramped.	space	0
Food was average but tasty.	Food	1
Big Wong gets big Ups for a fine establishment.	establishment	1
The entree was bland and small, dessert was not inspired.	entree	-1
The staff was the friendliest that have seen in New York.	staff	1
With the exception of our lemon salad that had so much pepper on it that our eyes started watering, the food here was decent, not great.	lemon salad	0
Delicious food at a great price but do not go here on a cold day and sit by the front door.	food	1
my picks: Guizhou chicken, fish with hot bean source, fish fillet in spicy source (special menu).	Guizhou chicken	1
Overall, I'm still impressed that the place even exists and the prices are quite decent but then again, its Chinatown.	prices	1
Admittedly some nights inside the restaurant were rather warm, but the open kitchen is part of the charm.	open kitchen	1
Pizza was a little soggy.	Pizza	-1
The only problem is that the manager is a complete incompetent.	manager	-1
The wine list is interesting and has many good values.	wine list	1
I'm still mad that i had to pay for lousy food.	food	-1
This restaurant used to be our regular Thursday night dinner location.	dinner location	0
Definite go if you're used to good Indian restaurant food from abroad.	Indian restaurant food	1
THR AT MOSHPHERE IS COMPACT, MODERN, YET COZY.	AT MOSHPHERE	1
By far, the best pizza in Manhattan.	pizza	1
Decent Thai food in cute - though a bit dank - little Nolita hangout, BUT service terrible.	Thai food	1
The waiter actually poured water on my hand and walked away.	waiter	0
The food is mostly made from scratch, fresh and well prepared.	food	1
NO more reservations, expensive tips and annoying stuff.	reservations	1
Try the sea bass.	sea bass	1
$20 gets you unlimited sushi of a very high quality- I even took a friend here from Japan who said it was one of the best sushi places in the US that he has been to.	sushi	1
Sushi wasn't anything spectacular for the price.	Sushi	0
During our meal, the management came over and checked on us and even bought us a round of drinks.	meal	1
But they don't have a toaster, which is strange.	toaster	-1
So, for good food i'd recommend it, but not for a fun night out.	food	1
The menu choices are similar but the taste lacked more flavor than it looked.	menu choices	0
A must for all the Dosa lovers.	Dosa	1
The portions are HUGE, so it might be good to order three things to split (rather than one appetizer and entree per person) for two people.	portions	1
The appetizers are just OK and the main courses were decidedly subpar.	appetizers	0
Someone else recommended the dessert - we also left that.	dessert	-1
The exotic food is beautifully presented and is a delight in delicious combinations.	exotic food	1
Try the mediterranean salad, it is a true experience for your taste buds!!	mediterranean salad	1
People are always friendly.	People	1
The cream cheeses are out of this world and I love that coffee!!	cream cheeses	1
From the entrees to the sides to the drinks, everything was creatively prepared yet still simple.	entrees	1
Service was prompt and courteous.	Service	1
It was not above ordinary and the beef version had cheap (undercooked) beef.	beef version	-1
Chance is a small cozy restaurant, with a romantic feel to it, the decor is great.	decor	1
It was nice and fresh, but I can't give it high scores on being authentic thai.	thai	-1
Only wine and beer are served, but the house varities are actually quite good.	wine	1
This place must have cost the owners afortune to build.	cost	0
Oh, and the complimentary pudding dessert was just enough- yummy!	pudding dessert	1
we split a tasty vegetable samosa and the malai tikka wrap.	vegetable samosa	1
Knowledge of the chef and the waitress are below average.	chef	-1
We were walking around the village and went into this place just for some drinks.	drinks	0
Decent wine selection too.	wine selection	1
It saves walking in and waiting for a table in the often noisy, crowded bar at dinnertime.	waiting	-1
I have to say I have never had a disapointing meal here.	meal	1
Mine was a little burnt but still delicious with goat cheese and panchetta (raddichio was kind of bitter though).	goat cheese	1
Disappointing food, lousy service.	food	-1
If you want a casual neighborhood bistro that has great food and excellent service, this is the place.	food	1
great place to go for a drink too because they have 100 kinds of beer.	drink	1
Over price, and small portions .	price	-1
Meanwhile, the bartender continued to pour champagne from his reserve after we had finished our bottle and we enjoyed an amuse of turnip soup with pureed basil, gratis.	bartender	1
The food was well prepared and the service impecable.	food	1
BUt their best dish is thh Thai spiced curry noodles with shrimp - a dish that would cost $23.95 is most places, but it is $16 here.	dish	1
Good, dark atmosphere and the music is a nice touch.	atmosphere	1
My husband said the portions were very small, but if my main course was good to eat the portion would've been fine for me.	portions	1
Great for groups, great for a date, great for early brunch or a nightcap.	brunch	1
Our friendly server made great food suggestions and also sent both the sommelier and the fromager to the table to help suggest different pairings for wine and cheese.	server	1
Because we didn't have a reservation, we could only sit in the back garden, but it was great, secluded and perfect in nice weather.	reservation	1
Stuffing yourself with Japanese food is a rare thing.	Japanese food	0
While the food was good (certainly no Il Mulino) the service was horrendous.	food	1
Service is not what one would expect from a joint in this price category.	Service	-1
Our family never expected such incredible entertainment in a restaurant.	entertainment	1
i would recommend reservations on weekends though.	reservations	0
Great pizza for lunch place.	pizza	1
The food was very expensive (we spent $160 for lunch for two) but extremely tasty.	lunch	-1
We were a group of 8 and well seved.	seved	1
The signs, the specials menus, food, and even all the waitstaff are ALL TOTALLY Japanese.	signs	1
I LOVE their spicy scallop roll, and my boyfriend consistently gets the sesame chicken.	scallop roll	1
I'm no food critic, but I'd like to think I have a tiny bit of experience under my belt having lived in NY for the last 11 years.	food	0
I noted it was crossed off on the bill.	bill	0
Best dish is nori-wrapped tuna.	dish	1
The food was absolutely amazing!!	food	1
Some servers make you feel like they are doing you a favor to bring you the food.	servers	0
An excellent alternative to fast food joints and ordering in but, the food was slightly disappointing.	fast food	-1
The staff is also attentive and friendly.	staff	1
The all you can eat deal is truly amazing here.	all you can eat deal	1
That is a problem since we paid about 20 bucks a dish, and had to order 5 dishes to get a decent taste.	dish	0
They were such a rip-off ($8.95 for four small meat patties in steamed buns) and not worth trying.	meat patties in steamed buns	-1
All of the pizzas are terrific and the price is even better!	pizzas	1
It is about FOOD and Ambiance, and imagine how dreadful it will be it we only had to listen to an idle engine.	FOOD	-1
The food was good too.	food	1
Immediately after we paid, the waiter took the money and said, okay, you guys are outta here.	waiter	-1
The dining room is quietly elegant with no music to shout over -- how refreshing!	dining room	1
Admittedly, this is not the place for gigantic pieces of fish overflowing the plate (and thank goodness, in my opinion) but for simple, elegant sushi there is no better place in New York or anywhere in the US.	fish	1
The menu seemed to have a wide variety of dishes for seafood lovers and interesting ways of preparing them.	menu	1
The white bean brushetta to start was incredible and the pasta was phenomenal.	white bean brushetta	1
The rest of the menu is limited by everything is good eats.	eats	1
The menu is nothing like the one on the website.	menu	-1
Great food, great lay out and awesome service.	food	1
Ive asked a cart attendant for a lotus leaf wrapped rice and she replied back rice and just walked away.	cart attendant	0
We walked in on a Wednesday night and were seated promptly.	seated	1
The wait staff is very freindly, they make it feel like you're eating in a freindly little european town.	wait staff	1
The waitstaff are all very busy, it's not outstanding service, but I've never been dealt with rudely.	waitstaff	-1
I have lived in Japan for 7 years and the taste of the food and the feel of the restaurant is like being back in Japan.	taste	1
They have it all -- great price, food, and service.	price	1
The flavors are great, and the menu is extensive.	flavors	1
The food was amazing, the service was so attentive and personable, and how about that ambience!	food	1
I found the variety of the sashimi plate to be satisfying - fresh and yummy.	sashimi plate	1
And forget what you read under me, the atmosphere isn't that bad either.	atmosphere	0
We couldn't carry our conversation as we were routinely interrupted by waitress and servants asking us to order and hinting that we're taking too much time -- amazing, we just sat down.	waitress	-1
sometimes i get good food and ok service.	food	1
It's a place for people who pay a lot for mediocre food, noise and a chance to be with their fellow bridge and tunnel folks.	food	0
After complaining about the chicken dish, the manager came over to tell us that, no one had ever complained before, and that we just didn't know what the dish was supposed to taste like.	chicken dish	0
The food was spicy and delicious.	food	1
Went for a late weekday lunch.	lunch	0
Bartender was unable to tear himself away from friends at bar.	Bartender	0
Anyways, if you're in the neighborhood to eat good food, I wouldn't waste my time trying to find something, rather go across the street to Tamari.	food	1
Dahkin also offers prix fixe lunch and buffet.	prix fixe lunch	1
This was my frist time at Cafe St. Bart's and I must say how delicous the food and the service was.	food	1
Went on a double date with friend and his girlfriend for a few drinks and appetizers.	drinks	0
Great place to grab a hot bagel on the way to work.	hot bagel	1
It's like they took leftover chicken, poured oil and sprinkled pepper powder over it (the sauce was translucent and red).	chicken	0
One would think we'd get an apology or complimentary drinks - instead, we got a snobby waiter wouldn't even take our order for 15 minutes and gave us lip when we asked him to do so.	drinks	0
We actually gave 10% tip (which we have never done despite mediocre food and service), because we felt totally ripped off.	tip	0
We were looking forward to nice glass of Sangria when we arrived.	glass of Sangria	1
I would highly recommand requesting a table by the window.	table by the window	1
While we enjoyed the food, we were highly disappointed by the poor service (waiter was not quite competent and SLOW service) and lack of remorse.	food	1
The service, however, was a bright flower in a garden.	service	1
We've been to Grocery three times and not once has an item on the menu disappointed.	menu	1
The food is very good too but for the most part, it's just regular food, nothing special.	food	1
A touch more jalapeno heat for contrast and it would have been very good indeed.	jalapeno	1
Tried the pad see ew on the recommendation of the last reviewer since it's one of my favorite dishes.	pad see ew	1
We ate out in the back patio, which is worth it as it's cool and the music is hear well there.	back patio	1
The location is perfect.	location	1
Guacamole+shrimp appetizer was really great, we both had the filet, very good, didn't much like the frites that came with, but the filet was so good, neither of us cared.	Guacamole+shrimp appetizer	1
The lunch special is an asbolute steal.	lunch special	1
This food is asian-air fusion.	food	0
Nothing fancy but really good food with pretty reasonable price.	food	1
The chicken pot pie is excpetiona, the cheeseburger huge and delictable, and the service professional wan warm.	The chicken pot pie	1
While I quite liked the food and the ambience, I'm not quite sure if it they really deserve it the Michelin rating they have displayed so prooudly in the window.	food	1
Once for dinner and once for brunch.	dinner	0
Not worth the prices.	prices	-1
From the moment you enter till the moment you walk out the friendly and helpful staff was was just Fantastic.	staff	1
Service was good and food is wonderful.	Service	1
She gets 10 for her excellent service and advice.	service	1
The restaurant is a bit noisy but that is something that can be overlooked once you sit down and enjoy a great meal	meal	1
being a fan of spicy ethnic foods, indian included, i made friends with this place long ago.	spicy ethnic foods	1
And I say snacking because it really is not set up to be a proper dinner.	snacking	0
The quality of food at this restaurant accompanied  by fantastic live jazz makes this place a perfect 10!	quality of food	1
I have eaten at Saul, many times, the food is always consistently, outrageously good.	food	1
(Always ask the bartender for the SEASONAL beer!!!	bartender	1
If your visiting, you'll enjoy the ambiance and the fact that it's in Time Sq...	ambiance	1
We were on our way back to NJ, and since I am in NY, we figured why not grab some food?	food	0
LOVE the atmosphere - felt like I was in Paris.	atmosphere	1
Every course was better than the next.	course	1
The staff is incredibly helpful and attentive.	staff	1
If presentation and service is your thing, then this magic show works.	service	1
Apparently, the good cook works then.	cook	1
The Yellowtail was particularly good as well.	Yellowtail	1
I ate clams oreganta and spectacular salad with perfectly marinated cucumbers and tomatoes with lots of shrimp and basil.	clams oreganta	1
The menu changed, portions were even smaller than before, a lentil dish was salty beyond edibility, a basmati rice dish lacked flavor.	menu	-1
Spice is sleek, modern and cool with a menu that will not hurt your wallet.	menu	1
Patroon features a nice cigar bar and has great staff.	cigar bar	1
Very affordable and excellent ambient!	ambient	1
More important, the sushi rivals the best in Tokyo.	sushi	1
I have never had cheescake like this.	cheescake	1
My co-workers had to wait almost an hour for delivery, only to discover that what they got was not what they ordered.	delivery	-1
Its a go-to for dates as well as entertaining out of town guests.	entertaining	1
Why do people rave about the ambience.	ambience	-1
Were meeting up with some friends for a drink at Lafayette 161 and happened to walk by Thai Angel famished.	drink	0
Fluke sashimi drizzled with jalapeno-lime olive oil, the fruit of the oil nicely highlighting the fish's sweetness.	Fluke sashimi	1
Great sushi experience.	sushi	1
If you're looking for a great meal at a decent price, go to Del Frisco's!	meal	1
They charge $6.00 for rice.	rice	-1
My steak au poivre was one of the worst I've had.	steak au poivre	-1
The owner and staff are all Japanese as well and that adds to the entire ambiance.	owner	1
Try the congee and the donut like deep fried dough they call Ow Ley Soh, a delicious and sweet tasting bread.	congee	1
The food was delicious and the waiter was incredibly helpful and attentive (considering we were the only ones there for the first hour).	food	1
From the spectacular caviar to the hospitable waitstaff, I felt like royalty and enjoyed every second of it.	caviar	1
Perhaps this food is considered extreme to an Upper East Side resident, but for the rest of us who've actually eaten ethnic food, this is simply dull.	ethnic food	-1
The place was real empty but that was because this was the first Sunday they ever opened.	place	-1
This little place definitely exceeded my expectations and you sure get a lot of food for your money.	food	1
Ambience is delightful, service impeccable.	Ambience	1
Service was excellent, and the AC worked very well too (thank God, it was hot!).	Service	1
You get the sense that the people there care about their restaurant and about your experience and that is very nice.	people	1
Both are delicious, the cooks are friendly and are willing to take a moment and speak to you and shake your hand.	cooks	1
My friend ordered some of their special sushi rolls which had excellent presentation and tasted great!	sushi rolls	1
Although be warned their dinner menu to sit and take out prices are different.	dinner menu to sit	0
The staff was accomodating, the food was absolutely delicious and the place is lovely.	staff	1
my picks are:  - Scallion Pancake (fried with vegetable juice, very special and tasty)  - Guizhou Chicken  - Shredded Squid Family Style (one of my personal favorites)  - Sichuan Spicy Soft Shell Crab  - Shuizhu Fish (this one is for hardcore Sichuan food fans, I wouldn't recommend to my American friends as it's very spicy.	Scallion Pancake	1
They smell like they stuff them with old canned vegetables like the spinach mushroom calzone.	canned vegetables	-1
To celebrate a birthday, three of us went to Mare anticipating great food.	food	0
There was a great deal for 6 Blue Point oysters and a beer or glass of wine for $8!	Blue Point oysters	0
I really liked the noodle dishes at Rice Avenue compared to their Green Curry dish.	noodle dishes	1
But for whatever reason, prices are about twice as high.	prices	-1
I am relatively new to the area and tried Pick a bgel on 2nd and was disappointed with the service and I thought the food was overated and on the pricey side.	service	-1
Great atmoshere and worth every bit.	atmoshere	1
The spicy tuna roll was unusually good and the rock shrimp tempura was awesome, great appetizer to share!	spicy tuna roll	1
The staff was knowledgeable and full of personality.	staff	1
Only complaint would be that at an average cost of $12-$15 per meal, I'd like not to have to worry about finding a seat!	cost	0
To finish off such a delightful dinner experience you must have dessert, especially the White Chocolate Bread Pudding with Gelato and hot chocolate.	dinner	1
The banana tower is an amazing dessert as well.	banana tower	1
Excellent atmosphere, delicious dishes good and friendly service.	atmosphere	1
A cool place to hang with your friends for a couple of healthy drinks and desserts.	place	1
Great vibe, lots of people.	vibe	1
I like Mamoun's food as well, but side by side, Kati Rolls just produce tastier food hands down.	food	1
The service is a bit slow, but harkens back to my years growing up in Napoli, Italy where things are not rushed and when you sit down for dinner the table is yours all night.	service	1
But that wasn't the icing on the cake: a tiramisu that resembled nothing I have ever had.	icing on the cake	-1
Great food and the prices are very reasonable.	food	1
A cool bar with great food, and tons of excellent beer.	bar	1
Be sure to try the seasonal, and always delicious, specials.	specials	1
The ambience is authentic and relaxing and we have always received attentive and prompt service.	ambience	1
Fresh, authentic, french cuisine in substantial portions.	french cuisine	1
Drinks got screwed up, she acted put upon.	Drinks	-1
The one vegetarian entree (Abby's treasure) was actually quite a surprise - it was delicious and had wintermelon covering an assortment of fresh mushrooms and vegetables.	vegetarian entree Abby's treasure	1
At 5 dumplings for $1, you just cannot go wrong.	dumplings	1
But the pizza is way to expensive.	pizza	-1
And the staff is also young, energeic and hot!!!!	staff	1
Even better, they know how to cook French classics like Steak au Poivre and Onglet without burning it to death or overcooking it.	Steak au Poivre	1
Service was decent, but not as smooth as I would expect from a place with these prices and reputation.	prices	1
Good drink.	drink	1
We had a girls' night dinner here for restaurant week.	dinner	0
However, I was there for a work dinner not long ago when my colleague from London noticed a very large waterbug on the ceiling.	dinner	0
My chow fun and chow see was really bland and oily.	chow fun and chow see	-1
Even though I made the reservation at 3pm for the same night through Dinnerbroker, we were seated at a table with one of the best view!	reservation	1
we did notice however, that some tables had what looked like pita instead of naan.	pita	-1
I didn't take a look at the rest menu, but the oysters were fantastic.	menu	1
The grilled cheese at home afterwards was better.!!	grilled cheese	1
Great service, great food.	service	1
sometimes i get bad food and bad service, sometimes i get good good and bad service.	food	1
In summer-eat outside on a terrace (another great feature of Suan)!!!	terrace	1
It's the perfect restaurant for NY life style, it got cool design, awsome drinks and food and lot's of good looking people eating and hanging at the pink bar...	design	1
We did have to wait at the bar for approx.	bar	0
If you love seafood, you would love this place!	seafood	1
Good, fast service.	service	1
I was in love with Pongsri on 48th, but compared to Suan it is slow in service and overpriced.	service	-1
My friends and I experienced amazing cheese and a delicious, new summer menu at Artisanal last night.	cheese	1
It's charmingly small and that leads to an atmoshere that is extremely cozy and romantic, even.	atmoshere	1
It is obvious that no one in the restaurant has any idea about or experience with Japanese cuisine.	Japanese cuisine	-1
In terms of the food itself -- nothing special, we limited ourselves to several appetizers.	food	0
Love the Jazz bands on Fri and Sat.	Jazz bands	1
To begin, we were told there was a 30 minute wait and started to leave, when the hostess offered to call us on our cell phone when the table was ready.	wait	1
The servers give you some sample slices of your order while you wait (shortly I might add).	servers	1
The service was ok.	service	0
When asked about how a certain dish was prepared in comparison to a similar at other thai restaurants, he replied this is not Mcdonald's, every place makes things differently While it is understandable that every place is indeed different, there was not a need to be uncourteous to customers and downright rude.	dish	0
Don't expect to sit down inside though, there are only a few tables and they are always full.	tables	-1
The staff is accomodating, the ambiance is exciting and yet relaxed, and the food is out of this world!	staff	1
The manager claimed that he could not compensate us for anything on the bill which just shows the lack of sophistication from the entire group.	manager	0
it's the only place you can get yummy authentic japanese comfort food.	japanese comfort food	1
We took advanatage of the half price sushi deal on saturday so it was well worth it.	half price sushi deal	1
we came here on a crowded saturday night and were seated right away despite being 15 minutes late for our reservation.	seated	1
We were fast to order the appetizer platter since we were very hungry.	appetizer platter	0
The staff are attentive, and have smiles on their faces.	staff	1
No dress codes, no attitudes, plenty of comfort companionship, a great place to relax in an always busy Midtown.	dress codes	1
Even the pasta is delicious here (a rarity in New York pizza restaurants).	pasta	1
After my 3rd time the manager remembered me and treated me like an usual customer.	manager	1
now if they could only get a toaster.	toaster	-1
When he's not making authentic Neapolitan pizza in the open brick oven or lightly frying zucchini blossoms, he's visiting the regulars (a growing legion) and checking on newcomers.	Neapolitan pizza	1
Wait staff is blantently unappreciative of your business but its the best pie on the UWS!	Wait staff	1
The ingredients taste fresher, the crust is thinner and crispier, the slice is less oily, and it's never burnt like it occasionally is at Joe's.	ingredients	1
Fish is so very fresh.	Fish	1
The prices were CHEAP compared to the quality of service and food.	prices	1
Top spot in town for Vietnamese classics, better than places that cost a lot more.	Vietnamese classics	1
The decor is really blah, and not at all hip or happening.	decor	-1
Having discovered Ping's on the internet, we entered with qualms but were instantly put to ease by the fish tanks that greet you as u walk in.	fish tanks	1
It appears to be the owner's first venture and it shows.	owner	-1
I come from a family of pizzeria owners, and I'm almost ashamed to say that the pizza in Fornino's blows my families receipies away.	pizza	1
We ordered some beef and noodle soup dishes from the Thai section of the menu but nothing we got was Thai.	beef	-1
They have a huge selection of different cream cheeses and all of their salads are great.	cream cheeses	1
The lobster sandwich is good and the spaghetti with Scallops and Shrimp is great.	lobster sandwich	1
The food was authentic.	food	1
The dim sum is delectable while the prices are quite easy on the wallet.	dim sum	1
I only tried a simple dish of spinach ravioli in a light oil and garlic sauce, but it actually faired better than most NYC Italian joints I've tried similar dishes at.	dish	1
The worst excuse for Japanese food I've ever encountered.	Japanese food	-1
I ordered a Chicken Teriyaki dish and found that the chicken was extremely dry.	Chicken Teriyaki dish	-1
We had reservations at 9pm, but was not seated until 10:15pm.	reservations	-1
We had Pam's special fried fish and it was amazing.	Pam's special fried fish	1
There is no excuse for such lousy service!	service	-1
My boyfriend had the New England Chowder it was good but I think the award should go to the Lobster Bisque.	New England Chowder	1
So, a little inconsistency there but either way, both pizzas were really good.	pizzas	1
Overall the restaurant is more expensive than our other sushi favorites, but everything was delicious.	sushi	0
Not enough wines by the glass either.	wines by the glass	-1
I had the duck breast special on my last visit and it was incredible.	duck breast special	1
I must say it's a little pricey for the food because it was not as spectacular as the view.	food	-1
These innovators of french indian fusion do a great job of making dishes as interesting as possible while still being accessible.	french indian fusion	1
Just don't take the seat between the bar and the back half of the restaurant, i saw a woman get nudged 40times sitting there.	seat	0
We were worried we would have trouble getting in, but somehow managed to have a short wait.	wait	1
My wife had the fried shrimp which are huge and loved it.	fried shrimp	1
One should not go to Lucky Strike for the food.	food	-1
The service is awful--the last time I was there (and I do mean the last time) we were told that they needed our table so we would have to leave.	service	-1
We could only get through an appetizer and cheese fondue.	appetizer	0
night without a reservation, we had to wait at the bar for a little while, but the manager was so nice and made our wait a great experience.	reservation	1
Try the green curry!!!	green curry	1
We had the scallops as an appetizer and they were delicious and the sauce was wonderful.	scallops	1
We were also seated promptly at the time of our reservation and the service was very quick and professional.	reservation	1
You rarely have to wait for a seat and the currys (masaman, green, red) are full of flavor and come super spicy if you ask for it.	seat	1
The food there are sastifying.	food	1
I highly recommend visiting this restaurant and having dinner and drinks!	dinner	1
The bar is very well stocked with interesting beers and well priced wines.	bar	1
Last memorial day, I tried to make reservations but was told they were closed that weekend (interesting, but...).	reservations	-1
The food was good.	food	1
Great wine selection, Gigondas is worth the price, and the house champagne is a great value.	wine selection	1
at night, but it's hard to hear your own conversation with everyone else competing for that same luxury - the music playing in the background is also voluminous.	music	-1
I have enjoyed everything I have ever gotten and the fish is so fresh and always prepared in a great way.	fish	1
I particularly love their yellowfun tuna and their mussel selection.	yellowfun tuna	1
I love to visit Murrays for my bagel fix.	bagel	1
We made early dinner reservations and were thoroughly impressed, reminds me of my grandfather, its old school Italian scenery with lots of fun stuff to admire.	dinner reservations	1
The place was nice and calm.	place	1
Cheese plate is a varied delight and great bargain at $10.	Cheese plate	1
I could have drank 4 glasses of water and still been parched - so watch out.	glasses of water	0
When we sat, we got great and fast service.	service	1
Most of the servers are very attentive, friendly and quite attractive.	servers	1
Service is average.	Service	0
They forgot a sandwich, didn't include plastic forks, and didn't include pita with the hummus platter.	sandwich	0
The steak is good, the fish is good and the sushi was surprisingly great.	steak	1
I am reluctant to write because I would not want my jem of a pizza place to become overcrowded.	pizza	1
The service was poor, restaurant poorly lit, staff not very attentive and I would have rather eaten at a Mcdonald's than this joint.	service	-1
My GF and I still choose to eat there a lot because of diverse cocktails, the chill decor, and the decent sushi.	cocktails	1
We ended the dinner with a surprisingly light and flaky apple tarte tatin.	dinner	1
The buffet had a nice selection.	buffet	1
Waitstaff are very friendly.	Waitstaff	1
Service was slow had to wait to order and get food although not crowded.	Service	0
Will have to return to try the chocolate!	chocolate	1
The food was below average, the service was pathetic, there was no ambience at all.	food	-1
I REALLY ENJOYED THE SHOWS PUT ON BY THE ACTORS.	SHOWS	1
Our first time in New York and we had to try a New York Bagel.	New York Bagel	0
service was efficient courteous.	service	1
The miso soup lacked flavor and the fish was unfortunately not as well prepared as in the past.	miso soup	-1
They are the best bagels I've had.	bagels	1
I've read some of the previews reviews - people are either not New Yorkers or have more appreciation for ambience then food.	ambience	0
Toons has recently been redone, so it's now a very attractive space.	space	1
$160 for 2 filets, 2 sides, an appetizer and drinks.	filets	0
While the prices are nothing special, the portions are huge.	prices	1
Its a nice quiet location to go eat a good meal, relax, be able to talk and have a very good time.	location	1
We arrived for dinner expecting to be impressed by a place that has an impressive past - but, that's just it -- the PAST!	dinner	0
However, I think this place is a good hang out spot.	spot	1
The menu is Prix Fixe, so be prepared to spend at least $60 per person, but it is Well worth itsuperb food.	menu	1
The wine list is extensive and impressive.	wine list	1
We had the most wonderful waitress.	waitress	1
The quail was fantastic and unique and the pastas were full of flavor.	quail	1
The zucchini and mashed potatoes are a blend of garlic and butter which simply melts in your mouth.	zucchini	1
Decor is nice though service can be spotty.	Decor	1
Aside from the rushed service, we were very impressed with the food and the drinks.	service	1
Make sure you have the Spicy Scallop roll.. .	Spicy Scallop roll	1
I would highly recommend this place to anyone who is looking for a fine Indian dining experience that is definitely a value for your dollar.	Indian dining experience	1
Some of the workers ignore me and talk to the female customers, other times, they've skipped my order.	workers	-1
The specials are usually quite good too.	specials	1
They've the best desserts and mixed drinks as well as snack foods.	desserts	1
Try the chocolate mud cake (warmed) with 2 scoops of dulce de leche gelato.	chocolate mud cake (warmed)	1
Really cool stauff inside.	stauff	1
While the new restaurant still features much of the same classical furniture that made Tiffin so attractive, the menu has been overhauled.	classical furniture	1
We visited Orsay during NY Restaurant Week and tried their $35 menu.	menu	0
I would have gotten some cole slaw and a knish if my stomach had more space.	cole slaw	0
The blond wood decor is very soothing, the premium sake is excellent and the service is great.	blond wood decor	1
Your money could easily be better spent elsewhere (Anywhere).	money	0
Only drawback - they won't toast your bagel, and they don't make eggs for the bagel.	bagel	-1
As always we had a great glass of wine while we waited.	glass of wine	1
The wait staff is pleasant, fun, and for the most part gorgeous (in the wonderful aesthetic beautification way, not in that she's-way-cuter-than-me-that-b@#$* way).	wait staff	1
Of course this atmosphere is lacking, but what do you expect from a 24 hour bagel place anyways?	atmosphere	0
Service was very good and warm.	Service	1
For dinner I had the chicken tikka-masala and some garlic naan.	dinner	0
Cornelia Street looks like a Broadway set for West Side Story and the inside of Po is so cool quaint you really can't top the setting for a romantic dinner in NYC.	setting	1
Food was good and the view of the new york city skiline was terrific even on a foggy rainy day like that of when I went.	Food	1
The food is nothing like its menu description.	food	-1
Try the Pad Se-Ew or Chicken with Cashew Nuts for a memorable and repeatable experience.	Pad Se-Ew	1
It's just O.K. pizza.	pizza	0
The food is decent at best, and the ambience, well, it's a matter of opinion, some may consider it to be a sweet thing, I thought it was just annoying.	food	0
The service was a bit slow, but they were very friendly.	service	-1
Leon is an East Village gem: casual but hip, with well prepared basic French bistro fare, good specials, a warm and lively atmosphere.	French bistro fare	1
The food is above average for midtown and sligtly better than some of the other Heartland Breweries in the city.	food	1
Thius is a must for anyone who loves Shabu-Shabu.	Shabu-Shabu	1
Similar to other Indian restaurants, they use the dinner special to attract customers at the door.	dinner special	0
The people with carts of food don't understand you because they don't speak English, their job is to give you the delicious food you point at.	food	1
The crackling calamari salad, which is usually a cheap disaster at many restaurants, is crispy and lightly dressed.	crackling calamari salad	1
Not the greatest sushi place, but excellent for a $19.95 all you can eat.	sushi place	-1
Shockingly easy to throw a group dinner here: simple contract, deposit only to hold the date the entire 2nd fl mezz for our grp of 20.	group dinner	0
The Thai ice tea was amazingly smooth and yummy!	Thai ice tea	1
We've never had any problems with the staff but maybe we've been lucky?	staff	1
Drinks way over priced.	Drinks	-1
The main downside to the place is the nazi-like guy running it who constantly complains about the noise level.	guy	-1
What I didn't like was how the food came right after it was ordered.	food	-1
Moderate prices.	prices	0
I think I've had some the best meals of my life at minnow.	meals	1
Most importantly, food is excellent.	food	1
Great roofdeck, nice group of 30 somethings, but no music, kind of quiet.	roofdeck	1
The best part of the experience was knowing that the manager (a bubbly, friendly young woman with a great smile) truly cared about how we were doing.	manager	1
However, service was as plain as sesame crusted Salmon I had.	service	0
It's great to go for a quick lunch either alone or with a friend.	lunch	1
So some of the reviews here are accurate about the crowd and noise.	crowd	-1
You get what you pay for and with that logic in mind, Spice is a great place to grab some cheap eats and drinks in a beautiful setting.	eats	1
The service was terrible, we had to wait for everything and ask several of different people for the same thing before we were allowed to be served.	service	-1
Other than being a little crowded and a bit overpriced, the atmosphere is filled with energy (and the beautiful people of course) and the food was surprising good!	atmosphere	1
We only ordered desserts and drinks, but no refills were offered.	desserts	0
I have been here a few times for dinner, once for brunch and twice for lunch.	dinner	0
The bread and lamb chops I had before the meal were quite good, however.	bread	1
Rao's has the best service and atmosphere in NYC.	service	1
instead ordered an ice cold beer which to me works with indian.	beer	1
They never brought us complimentary noodles, ignored repeated requests for sugar, and threw our dishes on the table.	noodles	-1
one of the best Chicken Tikka Masala.	Chicken Tikka Masala	1
The kitchen however, is almost always slow.	kitchen	-1
The corned beef and pastrami are excellent, much less fatty than those big tourist places around Times Square.	corned beef	1
Cute place, nice wait staff but would never go there again.	place	1
people are rude bit again it's new york!	people	-1
The plain slice is great and if you get toppings, the whole slice is topped with them, not sparsely sprinkled on like some places.	plain slice	1
Service was also horrible and the ambience is not that great.	Service	-1
Service is great, takeout is good too.	Service	1
The pizza is overpriced and soggy.	pizza	-1
Everything is excellent, the menu is quite extensive, and you eat with a view on both sides of the city.	menu	1
For the quality of food, a little too expensive.	quality of food	-1
Here's to the fake fish tanks too...	fish tanks	-1
I've never had bad service and the fish is fresh and delicious.	service	1
we decided to eat in tea room which was small and cute.	tea room	1
Unique apppetizers.	apppetizers	1
The staff has always been attentive and kind, and I've always been amazed at how they've handled all the various different group sizes that come in.	staff	1
IT is the best deal in town for a Monday night dinner at a fine restaurant.	dinner	1
Also, the sandwiches (nearing $7) didn't come with anything like chips or a side.	sandwiches	0
The wait here is long for dim sum, but if you don't like sharing tables or if the typical raucous dim sum atmosphere is not your gig, this is a sleek (for Chinatown) alternative.	wait	1
This place has good potential, but needs a significant amount of work before we can justify spending that much money on indian food you can get everywhere else.	money	0
Everything is always cooked to perfection, the service is excellent, the decor cool and understated.	service	1
The Thai food is good.	Thai food	1
Great selection of wine, and seafood.	selection of wine	1
Acceptable prices.	prices	1
we were seated at the sushi bar in front of yasuda.	sushi bar	0
As I made the title, it's an affordable restaurant for great taste.	taste	1
Definitely not worth the price!	price	-1
Orsay, is a very pleasnt throw back to traditional French food, and French service as well.	French food	1
It's easy to get a table for a large group and you don't get hustled out.	table	1
Great food at reasonable prices.	food	1
If you've ever been along the river in Weehawken you have an idea of the top of view the chart house has to offer.	view	1
The prices are about $9 for an entree for dinner and even less for lunch.	prices	1
and you can't beat the prices.	prices	1
Should you happen to be impressed by the cuisine definitely try it.	cuisine	1
I had the black cod with yuzu sauce, which was wonderful.	black cod with yuzu sauce	1
Prices too high for this cramped and unappealing resturant.	Prices	-1
Total hipster-wannabe attitude in an otherwise sweet spot.	spot	1
Yes, there might be a wait if you have no reservations.	wait	0
Everything, from the soft bread, soggy salad, and 50 minute wait time, with an incredibly rude service to deliver below average food.	bread	-1
The sicilian is my favorite it is moist not dry like most places but all their pizza is great!	sicilian	1
Downstairs lounge is always a good attraction	Downstairs lounge	1
The menu prices are a bit expensive for what you get in quality and portion size.	menu prices	-1
The food was amazing, and the service was prompt and helpful, but not over-bearing or rushed.	food	1
(food was delivered by a busboy, not waiter) We got no cheese offered for the pasta, our water and wine glasses remained EMPTY our entire meal, when we would have easily spent another $20 on wine.	food	0
The takeout is great too since they give high quality tupperware as well.	takeout	1
The food was not fresh, the sauces were bland and very oily.	food	-1
Could be pricey without a prix fixe meal.	prix fixe meal	-1
This is definitely an  excellent date spot because of the ambiance and on the weekends the  night scene is more than alive.	spot	1
One of us actually liked the expresso - that's it.	expresso	1
Again, the waitress was awesome.	waitress	1
I loved everythig about it-especially the shows and actors.	shows	1
The service was fast and friendly and the food was very tasty and they had the best hot sauce to add to your meals.	service	1
The food was just OK, I would never go back.	food	0
Zero ambiance to boot.	ambiance	-1
Scalina Fedeli reminded me why service is so integral to fine dining.	service	1
i recommend the thai popcorn :)	thai popcorn	1
Everything looks great, the drinks, the decor, the food, even the people.	drinks	1
As soon as my father lifted his pen from the check a chef appeared to usher us out.	check	0
The parathas and kebabs are made when ordered ensuring a level of freshness that is unsurpassed.	parathas	1
The tuna and wasabe potatoes are excellent.	tuna	1
The only disappointment was the coat check girls who didn't seem to know what a customer is on a realtively non-busy night (for the coat check girls).	coat check girls	-1
My fiance took me to Scopa last week for my birthday and I couldn't believe the food.	food	1
Ummm...the beer was cold.	beer	1
We had great desserts (including the best cannoli I've ever had) and then they offered an after dinner drink, on the house.	desserts	1
Good crowd, good outdoor seating, with a hip japanese vibe.	outdoor seating	1
We asked to be moved (which took half an hour), and then were seated in a high traffic area in the back, even though the rest of the room was practically empty.	area	0
Good to find a restaurant where the owners have some imagination and they have actually pulled it off, like in this case.	owners	1
However, their popularity has yet to slow down, and I still find myself drawn to their ambiance and delectable reputation.	ambiance	1
Where tanks in other Chinatown restaurants display a lurking myriad of sad-looking marine life in their murky waters, the tanks at Ping's are clear as glass with healthy-looking creatures who do not yet know that they will be part of some dim sum lover's brunch.	tanks	0
The Halibut was too salty, dessert was so so (don't waste any of your calories) and service was poor.	Halibut	0
The view is spectacular, and the food is great.	view	1
The place wasn't too hard to find, but it was kind of packed, as soon as my boyfriend and I got our food, the line reached the door.	food	0
Good bagels and good cream cheese.	bagels	1
The food is wonderful, tasty and filling, and the service is professional and friendly.	food	1
It is also extremely well priced.	priced	1
Always great service!	service	1
I am happy i did the food was awsome.	food	1
We ordered the chicken casserole, but what we got were a few small pieces of chicken, all dark meat and on the bone.	chicken casserole	-1
A bit breezy up there on the mezzanine from the wind coming from the tracks.	mezzanine	-1
I went to DF for Valentines Day dinner.	Valentines Day dinner	0
I recommend the jelly fish, drunken chicken and the soupy dumplings, certainly the stir fry blue crab.	jelly fish	1
I LOVED THE SHOWS.	SHOWS	1
The aesthetics of this place are like an airport lounge.	aesthetics	-1
Then, get ripped on free box wine.	box wine	1
My wife and I ate here earlier this week and have not stopped ranting and raving about the food.	food	1
The food itself was just ok - nothing spectacular - but the service was awful.	food	0
The pizza is yummy and I like the atmoshpere.	pizza	1
As there were so many to choose from we wandered up and down the street looking in the windows and such noticicing many empty seats ,except at Taj Mahal.	seats	-1
Good food.	food	1
those rolls were big, but not good and sashimi wasn't fresh.	sashimi	-1
The pesto pizza was excellent, thin-crust pizza with a nice amount of spicy Italian cheese that I'd never heard of before.	pesto pizza	1
try the spicy shrimp appetizer (again, not the greatest value in the world but worth the price) and the lamb vindaloo is great.	shrimp appetizer	1
However, go for the ambience, and consider the food just a companion for a trip across the world!	ambience	1
Food was good not great not worth the wait or another visit	wait	-1
I have had so many dinners here and it's always been perfect - on a date with my husband, with my mom, with girlfriends and larger groups.	dinners	1
When you want a piece of beef, head on over.	beef	1
Delicate spices, onions, eggs and a kick-ass roti.	spices	1
Incredible food at a very agreable price brings me back just about every other day to this authentic Thai restaurant.	food	1
The menu has lots of options: I hope to go back to try those potato pancakes.	menu	1
The staff isn't the friendliest or most competent, and I am stickler for service, but everything else about this place makes up for it.	staff	-1
My wife and I will usually only order one primi and one secondi and split them, as they tend to offer large portions.	primi	1
I've overheard comments from him to his employees that should not have been delivered in the dining area and I've been sitting there while he lectured another customer.	employees	0
Delicious crab cakes too.	crab cakes	1
This was the worst dining experience I've ever had.	dining experience	-1
I have been coming here for years and have nothing but good things to say about the service and the great staff at La Lanterna.	service	1
Just bring someone who speaks Cantonese because waiter may not understand you.	waiter	-1
The bruschetta and panini's are so yummy!	bruschetta	1
Food was okay, nothing great.	Food	0
Every waitress and customer who passed by me bumped into my chair.	waitress	0
Always popular, always full, always a wait.	wait	-1
It is run by the same Sichuan chef who started the chain in Chinatown.	Sichuan chef	0
I can't wait for summer, when they serve outside on their gigantic patio.	patio	1
Best Pastrami I ever had and great portion without being ridiculous.	Pastrami	1
If you are someone who appreciates the same things but hope to have food to spare or share, Kai may not be the best option.	food	0
go here for the drinks!	drinks	1
The first 2 courses were very good, but the chocolate sampler was too rich for me and the dessert wine far too sweet.	courses	1
Butter was melted, white wine warm, cheese oozing everywhere.	Butter	-1
We had a party in their private room and they made it truly memorable and were very helpful in the planning.	private room	0
It cannot be the ambience, because the place is very cramped and some guests have to sit in an aisle.	ambience	-1
We were disappointed with the pre-fixe menu of only 2 choices per course (other restaurants offer 3 choices) and ended up ordering a la carte.	pre-fixe menu	0
Authentic Pakistani food.	Pakistani food	1
The eggplant parmesan is also great, and my friend who grew up in Manhattan claims that no one serves a better baked ziti with meatsauce.	eggplant parmesan	1
Quality ingredients preparation all around, and a very fair price for NYC.	ingredients	1
Service was very good - prompt, attentive and non-intrusive.	Service	1
My entree of hot pot with seafood was full of imitation crabmeat with a couple pieces of shrimp and squid, and was unnecessarily heated with a burner.	entree	1
We began with the cheese fondue (the artisanal blend) and added apples and kielbasa to dip.	cheese fondue	0
In such a crappy part of town to find a good value for lunch, this place is great.	value	1
Its not curry in a slurry crap, and regular run of the mill food.	curry	0
In fact, while leaving the place we saw two people looking at the menu, and I couldn't help telling them that the food was horrible.	menu	0
Even though the restaurant was packed, we were seated promptly and even asked for a table upstairs with no problems.	seated	1
If you want Americanized Chinese food with your usual watery, generic white sauce, this is your place.	Chinese food	0
The bread is the soft paratha bread (unlike the plain bread they use in Calcutta), and the stuffing is tandoori styled and very flavorful.	bread	1
Service is friendly, prices are good - delivery time was a little slow, but for the way this pizza tastes, I'm willing to overlook it.	Service	1
The food can get pricey but the prixe fixe tasting menu is the greatest food for a good price and they cater the food to any food allergies or food you don't like.	food	1
The service is excellent, the decor is great, and the food is delicious and comes in large portions.	service	1
An excellent service	service	1
The food however, is what one might expect.	food	0
I LOVE their Thai noodles with shrimp and chicken and coconut juice is the MUST!	Thai noodles with shrimp and chicken and coconut juice	1
The pizza was really good.	pizza	1
Food is average, and I would say even the chain restaurant Baluchi's tastes better.	Food	0
The place is small and cramped but the food is fantastic.	place	1
The food is tasty and portion sizes are appropriate.	food	1
Kosher dills are the perfect compliment for your unforgetable sandwich and they give you plenty of them.	Kosher dills	1
The entertainment was great they have shows that go on through out the dinner.	entertainment	1
The food is so cheap and the waiters are nice.	food	1
The food there is so good that even to order out the wait is incredible.	food	1
The bartender on my most recent visit was so incredibly rude that I will never go back.	bartender	-1
Their sushi, Kamikaze and other Rolls are fresh and well presented.	sushi	1
For authentic Thai food, look no further than Toons.	Thai food	1
The highlight of the night was the mayonaisse for my side of fries I received from one of the food runners, which is not good considering the bill was nearly $100.	mayonaisse	0
I choose to go with one of the special, the braised lamb shank in red wine, which was excellent.	special	1
If anyones has doubt of not knowing enough about wines,please check their wine list.	wines	1
The only concern i have is with the slighly all-business waitstaff who order and throw the food down, rushing you out.	waitstaff	0
Have the iced tea.	iced tea	1
Small servings for main entree, i had salmon (wasnt impressed) girlfriend had chicken, it was good.	servings	1
you can actually get 2 salads worth if u take it home and add it to some lettuce!	salads	0
The ambience is very romantic and definitely a good place to bring a date.	ambience	1
It is far more popular as a bar than as a restaurant, with only a few tables and the waiter being the bartender, but we greatly enjoyed the unobtrusive atmosphere.	bar	1
The food is very good for it's price, better than most fried dumplings I've had.	food	1
There are much better places in NY with better prices.	prices	-1
Obv caviar is top of the line but the rest of the menu is so diverse it gives you a chance to taste so manydifferent varietys.	Obv caviar	1
Still, try it once, since if you end up loving the food, it could be one of your best dining experiences.	food	1
I've waited over one hour for food.	food	0
Other guests enjoyed pizza, santa fe chopped salad and fish and chips.	pizza	1
The ambience is very calm and quiet.	ambience	1
Both times I was extremely dissappointed by the service, which was boarderline rude.	service	-1
The spicy Tuna roll is huge and probably the best that I've had at this price range.	Tuna roll	1
Price and quality of fish alone will keep us from making a return visit.	Price	-1
Our waiter and all of the people helping him were attentive and genuine.	waiter	1
The place is a BISTRO which means: simple dishes and wine served efficiently in a bustling atmosphere.	place	1
This is one of the best comfort food places in the city.	comfort food	1
Overall, the ingredients and technique are there and I am encouraged enough to return at lunch or dinner to see whether the boldness of the flavour palette improves.	ingredients	1
I had a huge pastrami sandwich on a roll.	pastrami sandwich	1
Though you will undoubtedly be seated at a table with what seems like barely enough room (no matter what the size of your party), the warm atomosphere is worth the cramped quarters- you'll have fun and forgot about the tight spot you're in.	table	1
Considering their price of $6.25 for lunch special, the dish was ridiculously small.	price	-1
This is the pinnacle of Indian Fast Food (all fast foods in my opinion).	Indian Fast Food	1
Besides, when you have bad service, that's less money you have to tip.	service	-1
The wine list is also really nice.	wine list	1
Service was devine, oysters where a sensual as they come, and the price can't be beat!!!	Service	1
Compared to Ess-a, Tal offers a less doughy bagel!	bagel	-1
Ballato's is consistently delicious authentic italian food.	italian food	1
The service was attentive, yet discreet.	service	1
For those prices and the dressed up atmosphere you expect more and should get more.	prices	-1
They offer the same menu but have creative drinks that are loaded with alcohol and cheeky names -- but they do cost you.	menu	1
We went to eat at the Jekyll and Hyde restaurant on Friday night and really enjoyed the fun atmosphere and good food.	atmosphere	1
The food was pretty tradional but it was hot and good with large portions.	food	1
Unless you are eating in the Pizzeria side of this place, and are not in a rush, this place is a bad idea.	place	-1
You have to increase the service a lot.	service	-1
Ambiance is barely romantic but management tries.	Ambiance	1
I must warn the reader that the portions sizes are very small (especially the appetizers), so if you plan to eat until you are full and do not intend to order the chef's special tasting menu, prepare to order and pay for an appetizer (1 dish for each person because the portions are not for sharing), a main entree, and the cold udon at the end of the meal.	portions	1
After we got our sashimi order, I could not believe how small the portions were!	sashimi	0
After the main course came, we didn't see our waiter for at least 40 MINUTES!	main course	0
Nothing better than buying a snapple for $3.25 too.	snapple	1
When family came in he gave them apps to test their palets, and then ordered for them.	apps	0
Service is extraordinary, yet not overbearing, and the decor brings a taste of trendy SoHo into Queens.	Service	1
If I wanted to deal with a crappy scene and annoying customers I'd go out in Manhattan.	scene	-1
After a seafood craving, i checked citysearch and chose to go to Fish based on a previous review and the citysearch info.	seafood	0
Until you realize that their five minutes is meaningless and your wait may be anywhere from two to twenty minutes it may be frustrating.	wait	-1
Thalia is a beautiful restaurant with beautiful people serving you, but the food doesn't quite match up.	people serving	1
The fillings may be unconventional but the dosa batter is definitely authentic and the combinations very tasty.	fillings	1
This is the perfect spot for meeting friends, having lunch, dinner, pre-theatre or after-theatre drinks!	spot	1
The mussaman curry that I ordered was as thin as water and aside from the poorly fried tofu that I ordered in it, they graciously provided me with ONE piece of poorly cooked potato.	mussaman curry	-1
Had a late night dinner on a Saturday night.	dinner	0
A restaurant that doesn't try to do anything except serve great food with great service in a pleasant atmosphere.	food	1
Their sake martini is wonderful.	sake martini	1
Well, this place is so Ghetto its not even funny.	place	-1
Once they ran out of Gnochi and made it for me from scratch!	Gnochi	0
We would like to thank Marcelo and Grace for a wonderful dining experience!!!	dining	1
Found service above average, but that could be because we were 13 of us.	service	1
Bagels are ok, but be sure not to make any special requests!	Bagels	0
fine dining restaurant quality.	quality	1
Overall a disappointing experience for that price category.	price	-1
I've had the lunch buffet at Chennai a couple of times, when I have been in the neighborhood.	lunch buffet	0
The food was exceptional.	food	1
A Thai restaurant out of rice during dinner?	rice	0
The portions are small but being that the food was so good makes up for that.	portions	1
(and I have eaten my share) Which impresses me for having such a large amount of people to serve.	serve	1
Sure, the setting is nice.	setting	1
The service is friendly, if not the most prompt in the world, the food is great, and the prices, while not cheap, won't put your wallet out of commission.	service	1
Had 1 appetizer, 2 entrees and 2 cokes and the bill was ~$55.00, not including tip.	appetizer	0
Best drumsticks over rice and sour spicy soup in town!	drumsticks over rice	1
Slightly above average wines start at $70+ with only one selection listed at $30+.	wines	-1
Their whitefish salad is excellent--all whitefish with a little mayo.	whitefish salad	1
The chicken parm was edible but had canned tomato sauce and boxed pasta and the chicken with portobello mushrooms consisted of dry, inedible chicken with terrible sauce.	chicken	-1
I recommend this place to everyone who asks me where to go for a good meal.	meal	1
The waitresses are nice--also you can just get counter service sit.	waitresses	1
The only friendly staff member was the guy at the bar.	staff member	1
You can certainly find restaurants that offer a superior fine dining experience, but for superb food at reasonable prices, La Villa can't be beat.	food	1
Won't or Can't is not in the service directory.	service	1
I cannot imagine a friendlier staff working in a restaurant.	staff	1
I do suggest to ask to be seated upstairs if you are looking to be a little cozy.	upstairs	1
The red curry is weak and tasteless, the pad thai is stuck together and lumpy, the rice is often overcooked, and the seafood is pretty sketchy.	red curry	-1
The wine list is extensive and can easily hike up an otherwise reasonably priced meal.	wine list	1
Saul is pretty good, but definitely not great.	Saul	0
We always get a sampling of appetizers and share.	appetizers	0
Overall I was impressed and will return, it's a great QPR (Quality to Price Ratio).	Quality	1
It is nearly impossible to get a table, so if you ever have the chance to go here for dinner, DO NOT pass it up.	table	1
Their pad penang is delicious and everything else is fantastic.	pad penang	1
The puke green walls leave a lot to be desired, but the food is very good.	walls	1
The flavors are very fresh and pretty inobtrusive, nothing flashy.	flavors	1
I like Cafe Noir dont get me wrong, it is jsut that the people who work there are evil and incompetent!!	people	-1
The hanger steak was like rubber and the tuna was flavorless not to mention it tasted like it had just been thawed.	hanger steak	-1
big and soft as well as good lunch food.	lunch food	1
No food snobs allowed, this place is for people who appreciate good food.	food	0
I liked the food at this quasi-thai restaurant.	food	1
By far the best salad I have had in a fast food restaurant.	salad	1
As for the bar, this is another bad idea.	bar	-1
Their bagels are fine, but they are a little overcooked, and not really a 'special' bagel experience.	bagel	0
Unlike HH up the block, this place actually gives you hearty and hot bagels this town is known for.	bagels	1
The barebecued salmon is elegantly spiced and not at all dry.	barebecued salmon	1
Same owner as the guy who owns Typhoon, which is just down the street on St. Marks and 1st Ave.	owner	0
What generous portions!	portions	1
The workers there also absolutely load the bagel with cream cheese (gets a little messy).	workers	0
The wine the service was very good too.	wine	1
The highly spiced chai tea was great too.	chai tea	1
I have been there many times, and food is good and consistent.	food	1
Seriously, this is the best all you can eat in town- As everyone says, the Spicy Tuna hand rolls are the best- have 4 of these, and you've broken even.	Spicy Tuna hand rolls	1
While Sapphire is certainly not lacking in ambiance, and probably has the best decor of any Indian restaurant I have been to in New York City, the food was not what I had hoped for.	ambiance	1
I would highly recommend this place to anyone looking for a casual atmosphere that whisks you away to the left bank of the river Seine.	atmosphere	1
The meat dishes were only so-so.	meat dishes	0
His wife Tanya, the hostess, completes the comforting atmosphere by being delightfully warm and gracious.	hostess	1
The menu consisted of standard brassiere food, better then places like Balthazar etc.	menu	1
I have been a longtime fan of Holy Basil in the East Village, and while I do believe their food has slightly slipped in quality, I have been hesitant to be disloyal.	food	-1
But the best part about LS is the late night atmosphere, delightfully free of the BTs.	atmosphere	1
We even had a visit from the Manager who wanted to make sure we were enjoying ourselves.	Manager	1
The staff there is very attentive and down to earth.	staff	1
You don't go to Mizu for excellent service, you go for the large amounts of food, the amiable atmosphere, and the hole-in-the-wall feeling of the place.	service	1
The service is always bad though, don't expect much of anything from your server, and I would not recommend bringing a date here either.	service	-1
Monday nights are a bargain at the $28 prix fix - this includes a three course meal plus *three* glasses of wine paired with each course.	prix fix	1
It took them 15 minutes to put water in our glasses.	water	0
The service is descent even when this small place is packed.	service	1
I have eaten a lot of pizza here.	pizza	0
Great value for the quality ingredients.	ingredients	1
The Thali was small, thoroughly unremarkable, and $14.95.	Thali	-1
The sushi is also great!	sushi	1
From the complimentary chef app of a delicate butternut squash ravioli in a delicious truffle sauce to an amazing buttery and tender langostine entree to a dessert that I can't remember because of the fabulous Cakebread Cabernet we were drinking -- the whole evening was amazing.	chef app	1
Truly the mark of an attentive waiter.	waiter	1
The food here is rather good, but only if you like to wait for it.	food	1
I got an excellent piece of cheesecake and we had several other nice pastries.	cheesecake	1
The staff is very kind and well trained, they're fast, they are always prompt to jump behind the bar and fix drinks, they know details of every item in the menu and make excelent recomendations.	staff	1
The makhani was OK --the korma was bland.	makhani	0
The food is inventive but still keeps traditional indian flavoring.	food	1
The decor in this place is very diner-ish and the kind of place you expect in the East Village - not romantic, just simple, small and sparse.	decor	1
This is a cute place and could be good but they need to get their act together.	place	1
The lox is always fresh too.	lox	1
Service was very friendly.	Service	1
So all I'm trying to say is this restaurant is by far the best thai food restaurant I've ever been to.	thai food	1
We actually left hungry and went across the street to Wo Hop at 15 Mott street for some good chinese food.	chinese food	1
The duck confit is always amazing and the foie gras terrine with figs was out of this world.	duck confit	1
The whole set up is truly unprofessional and I wish Cafe Noir would get some good staff, because despite the current one this is a great place.	staff	-1
The staff offers impeccable service.	staff	1
We ended our great experience by having Gulab Jamun (dessert) recommended by the waiter.	Gulab Jamun (dessert)	1
This place doesn't compare with Mamoun's in terms of price, freshness, value, and consisent quality, but that's just my opinion.	price	-1
The place is sleek, modern and playfull and i will return again frequently.	place	1
I have known about this secret for the last 13 years, Emilio(the Godfather) has continued to serve food and wine for the gods at mortal prices.	food	1
After being told that our party of three would be seated in 10 minutes and watching other parties (multiples of 2 and higher) seated for 40 minutes, the three of us were squished into a small 2-person table.	2-person table	-1
And the bill was outragous.	bill	-1
The service was attentive, yet unimposing, the food was far better than many notorious restaurants in Midtown and the wine list is extensive and well priced.	food	1
Kind, attentive wait staff.	wait staff	1
Salads were fantastic.	Salads	1
The owners and employees are friendly and their pizza is fantastic.	owners	1
The food is yummy, especially their cooked-to-perfection mussels in spicy tomato sauce and their shoestring crispy fries.	food	1
The food is authentic Italian - delicious!	food	1
skip dessert.	dessert	-1
I complete the total bagel experience by having it lightly toasted.	bagel	1
It was like the servers forgot that they actually worked there and instead wanted to hang out and be cool.	servers	-1
The service is good and ambience is good for a date or group outing.	service	1
A great way to make some money is to buy a case of snapple from Costco and sell it right outside for only $2.50.	case of snapple	0
Fast service.	service	1
The staff is excellent, specjal: that girl behind the bar, european chic.	staff	1
stick with the chicken, beef, and lamb dishes.	chicken	1
We a menu that rearely changes,e xcept for one or two specials, the quality and care they put in thier food in evident.	specials	1
This restaurant is a wonderful place to go many times and it is reasonably priced.	priced	1
Bottom line: B+ for the food, F for the service.	food	1
The only thing the waiters don't do for you is wipe your chin when you leave.	waiters	1
Stick to dimsum, not super overpriced noodles.	dimsum	1
The service is fine and they allow you to enjoy the view.	service	1
We, there were four of us, arrived at noon - the place was empty - and the staff acted like we were imposing on them and they were very rude.	staff	-1
delicious simple food in nice outdoor atmosphere.	food	1
The only fallback on this restaurant is the prices.	prices	-1
I've been to Naples 45 for dinner twice.	dinner	0
The hot and sour soup was unbearably hot and tasted of only pepper and nothing else.	soup	-1
Try sushimi cucumber roll.	sushimi cucumber roll	1
The food is delicious.	food	1
Their wines by the glass are a great accompaniment and you can eat like a king with wine for under $30.	wines by the glass	1
This place has the the correct ambience and an excellent staff to make you feel like a guest and a friend at the same time.	place	1
Yeah Shanghai is also great but not quite as good -- they use the same amount of salt but without sweetness to balance out.	salt	-1
believe us, we've been eating sushi for over 15 yrs.	sushi	0
The atmosphere is much better than Sripraphai (more modern and sleek).	atmosphere	1
The food is outstanding and the service is quick, friendly and very professional.	food	1
The bagels always warm, soft on the inside, crispy on the outside and enormous in size.	bagels	1
I had a late dinner at Lucky Stike, a great name for a joint if ever I saw one.	dinner	0
Service is fast and friendly.	Service	1
from an English speaking staff.	staff	0
And they have these home made potato chips at the bar that are the most delicious things in the world!	potato chips	1
I went here with a friend on a whim, we went someplace else first and couldn't get a table.	table	-1
We all ate pasta entre'es, which were great.	pasta entre'es	1
The steak was excellent and one of the best I have had (I tasted the butter intitally but in no way did it overwhelm the flavor of the meat).	steak	1
The food was boring and expensive.	food	-1
The ambience is pretty and nice for conversation, so a casual lunch here would probably be best.	ambience	1
Terrific menu full of unique rolls and special dishes.	menu	1
The service is ok but could be better.	service	-1
We love the food, drinks, and atmosphere!	food	1
I was here a few weeks back and we had the worst customer service experience at a restaurant ever.	customer service	-1
Went on a 3 day oyster binge, with Fish bringing up the closing, and I am so glad this was the place it O trip ended, because it was so great!	oyster	1
Took my mom for Mother's Day, and the maitre d' was pretty rude.	maitre d'	-1
My husband and I have been there a couple of times and each time we sat at the sushi bar (chef Yoshi) and ordered everything ala carte.	sushi bar chef	0
The vibe is very relaxed and cozy, service was great and the food was excellent!	vibe	1
If the weather is nice, try to snag an outside table.	table	1
If you are looking for a good quality, cheap eats - this is the place.	quality	1
The service was friendly and the atmosphere was casual.	service	1
When I lived upstate for a while I would buy freeze the bagels and they would still be better than any else.	bagels	0
I recommend their Pad See Ew, Pork Chops or Tofu plates.	Pad See Ew	1
Never in my life did I think that I could be satisfied both in taste and in quantity for $3.00 in NYC.	taste	1
this is the best secret place in midtown', I heard that from the bartender, after having brilliant food ( try steak with portobello mushrooms) and drinks on the bar last Tuesday.	bartender	1
The service was excellent - friendly and attentive.	service	1
The main course had an average portion, and was decent overall.	main course	1
20 minutes for our reservation but it gave us time to have a few cocktails and enjoy our surroundings and each other.	reservation	1
Waitstaff is great, very attentive.	Waitstaff	1
The dinner menu is diverse and top-notch as well.	dinner menu	1
IT IS WHAT MODERN CUISINE IS ALL ABOUT.	CUISINE	1
I don't like Indian food too much and this was delicious, however you want to factor that into the equation.	Indian food	1
at taj, vegetarians can rejoice-all the dishes are manna from heaven.	dishes	1
I won't go back unless someone else is footing the bill.	bill	-1
We live in New Jersey and whenever we go into New York City we buy bagels to eat hot and then to freeze (they told me that if I call in the order, they'd bring it out to the car so I wouldn't have to look for parking).	bagels	0
Jimmy's is hands down the hottest night spot in the Bronx.	spot	1
And I would have to agree with the masses in terms of service - delivery is their Achilles' heel.	service	-1
The $300 bill was a bit steep, but the experience was great.	bill	-1
Nice ambiance, nice little bar, good bartender, Francois, and good service.	ambiance	1
The calamari comes with an incredible sauce, and the duck noodles are yummy as well.	calamari	1
Simple comfort food and what hot and lage portions.	comfort food	1
Stay away from the two specialty rolls on the menu, though- too much avocado and rice will fill you up right quick.	rolls	0
We didn't get drink refills and she didn't even offer us the option of dessert.	drink refills	0
The bagels are also reasonably priced for NYC.	bagels	1
If you can handle that, it's a great place for a business dinner, fun with friends or simply a table for 2.	business dinner	1
Decor leaves something to be desired.	Decor	-1
Also, specify if you like your food spicy- its rather bland if you don't.	food	0
Our waiter was fine, the place looks nice in that not-trying-too-hard way, but at those prices, a little more should be expected of your food.	waiter	1
Coming from Boston this place is like Emma's Pizza in Kendall Square in Cambridge (although they have more funky toppings!)	toppings	1
When my husband and go there, we spend $60.00 (have LOBSTER TAILS UMMMMM need I say more) I can't say any more, it a place you'll never forget If you never go, you'll miss A Meal of your life time	LOBSTER TAILS	1
in an effort to increase turnover, the restaurant offers no desserts beyond the complimentary espresso cup filled with chocolate mousse.	desserts	1
I've been to this restaurant more than a dozen times and when I'm craving for Pho, Lemon grass chicken or Beef Cube on rice, this is the place to go.	Pho	1
Oh yes, and if you are a fan of Indian oldies film stars, there are plenty of portraits of Indian actors and actresses in classic black white that adorn the walls, some of which, I would love to know where they obtained.	portraits	1
The food is spectacular, from the appitizers to the main course, and then of course the desserts, (WOW) you'll need no more.	food	1
My fish was delicious in an incredible curry sauce.	fish	1
If you are in search of the most authentic NYC deli experience look no further than the famous and historic Katz's Deli down on the Lower East Side.	deli	1
Even upon delivery, their juicy pork buns are quite good . .	pork buns	1
Average to good Thai food, but terrible delivery.	Thai food	1
The entire place and the treatment we received felt as a conveyor belt.	place	-1
Joe's Pizza used to have the best slice until this pizzeria opened up.	slice	1
And they provided a delicious dessert on the house!	dessert	1
They are still living in the dark ages and do not have an answering machine, so if you want to make a reservation you are limited.	reservation	-1
The food is amazing, rich pastas and fresh doughy pizza.	food	1
Food was very good, but not what I would consider out of this world.	Food	1
I had Lobster Bisque it has 2 oz. of Maine Lobster in it.	Lobster Bisque	1
Try the Pad Thai, it's fabulous and their prices are so cheap!	Pad Thai	1
Food is great and inexpensive.	Food	1
Dessert - can't be missed, so save room!!!	Dessert	1
It can be a little confusing as to where one goes to order, but once the food is ordered, you are in for a treat.	food	1
Ingredients are organic which is a real plus for me.	Ingredients	1
It was so bad I actually refused to pay for my food.	food	-1
I recommend this spot to anyone who enjoys  fine cuisine at reasonable prices.	cuisine	1
The staff was very attentive, the ambience lovely, and the food superb.	staff	1
I love when restaurants think using fancy expensive ingrediants makes the food fine cuisine, even with no idea how to use them.	ingrediants	1
THe Pizza and wine were excellent-the service too--but what really MADE this place was the backyard dining area.	Pizza	1
We all had the tasting menu and unlike some of the other reviews, I felt there was more than enough food.	menu	1
It only took about five or so minutes to get an empty table, but standing up wasn't too bad.	table	1
The menu may be small, but everything on it is delicious.	menu	-1
Warm, comfortable surroundings, nice appointments (witness the etched glass and brickwork separating the dining rooms).	surroundings	1
We ran a little late for the reservation but it wasn't a problem to get our table immediately.	reservation	1
We arrived on time for our reservation and seated promptly.The	reservation	1
I would definitely go back for a very special occasion, but not for regular fine dining.	dining	0
The flavors robust and subtle.	flavors	1
All I can say is $2 pints during happy hour and the some of the cheapest oysters you'll find in the city, though the quality is some of the best.	oysters	1
I would never wait for a table to eat, it just is not THAT great.	table	0
We concluded with tiramisu chocolate cake, both were delicious.	tiramisu chocolate cake	1
The counter service is bad.	counter service	-1
Service here was great, food was fantastic.	Service	1
This is such a lovely, peaceful place to eat outside.	place	1
The sauce is delicious and the crust is perfect.	sauce	1
Since my first dinner I have had the chance to have brunch at Orsay 3x.	dinner	0
You will pay a lot for the decore, but the food is no better or worse than a lot of other Chinese and Asian fusion places in NY.	decore	0
They have some great entrees here as well.	entrees	1
The service is not consistently excellent -- just decent.	service	0
They do cater to American palates, but if you like it hot let them know and they are more than willing to oblige!	cater	1
I had the mango chicken and i can't go on to tell you how delicious that was and the presentation was beatiful.	mango chicken	1
I care more about the food and ambience.	food	0
Oh, but wait, we were out of drinks (which were also delightfully overpriced).	drinks	-1
The service is fantastic.	service	1
The garlic mashed potatoes are hands down the best in the city!	garlic mashed potatoes	1
Food and service was okay.	Food	0
The lamb meat was under-cooked and EXTRMELY CHEWY.	lamb meat	-1
The best pad thai i've ever had.	pad thai	1
Over time, the food quality has decreased substantially, it is a lot less crowded than it used to, and the service must definitely be part of the reason.	food quality	-1
We were seated outside and the waiter spilled red wine and hot tea on myself and my date.	outside	0
i would just ask for no oil next time.	oil	-1
While this is a pretty place in that overly cute French way, the food was insultingly horrible.	place	1
The wine list isn't great, and the desserts are shipped in from Bruno's down the street, which is not as good as it used to be.	wine list	-1
I ordered a Lassi and asked 4 times for it but never got it.	Lassi	0
great wine list (italian), good food, service was INITIALLY fine.	wine list	1
Despite the fact that the space is large, they've overcrowded the floor with tables.	space	1
They are not helpful in the least and will give you the grand run around so by the time the event date rolls around you will not only regret chosing this place, but also become hostile!	place	-1
I had to ask her three times before she finally came back with the dish Ive requested.	dish	0
Normally that would be improper, however they were all delicious and my host did not complain.	host	0
Taxan delicious!	Taxan	1
Unlike other places in NYC where the sandwiches you want only come as a triple-decker, here you can get what you want in a reasonably-sized portion (and price).	sandwiches	1
Southern Indian cuisine is still there, too.	Southern Indian cuisine	0
Restaurant snobs need not bother, this is a small, neighborhood kind of place.	place	1
They couldn't even make a salad that was appealing.	salad	-1
For two people with tip was less than $25 bucks.	tip	0
Killer Sushi!	Sushi	1
Of course the reason its so packed is because the food is so delicious!	food	1
Staffs are not that friendly, but the taste covers all.	Staffs	1
The jukebox plays everything from Italian Opera to The Strokes.	jukebox	1
Plus they made a perfect martini.	martini	1
I am not sure if I would call the food here Indian as it is a fusion of what seems to be French with an Indian or exotic touch.	food	0
The waiter was attentive.	waiter	1
Their Margarita is best I've had since I've returned from Naples!	Margarita	1
The tastes makes your mouth water for more.	tastes	1
Their sake list was extensive, but we were looking for Purple Haze, which wasn't listed but made for us upon request!	sake list	1
The food was actually aweful.	food	-1
They are served with a free appetizer and the portions are perfect for lunch.	served	1
There is actually space to breathe and the decor sets the tone for an intimate dinner.	space	1
We went around 9:30 on a Friday and it had died down a bit by then so the service was great!	service	1
My husband and I both ordered the Steak, medium.	Steak	0
The sushi is average and the prices are anything but.	sushi	0
My wife and I also enjoyed the spinach, the Shanghai low mein, and other attractions.	spinach	1
Owner must have coem on this website to give himself credit.	Owner	0
Turned out there was full service upstairs and sat down.	service	1
Several of the dim sum orders had about 6-8 pieces.	dim sum orders	0
Three page wine menu, one page entree and horedevous.	wine menu	1
The food is consistently wonderful - I've been coming here for years, and the owner has always been accomodating and friendly.	food	1
The waiters and owners were nonchalant about this and promised to call the exterminator but weren't as dismayed or apologetic as I would have expected.	waiters	-1
And the food was fantastic.	food	1
If you're looking for a place to sit down, have a drink and conversations with friends, go to sweet-n-tart and order yourself a hong-kong styled milk and tea with tapioca pearls (hot).	drink	1
Aside from the Sea Urchin, the chef recommended an assortment of fish including Fatty Yellow Tail, Boton Shrimp, Blue Fin Torro (Fatty Tuna), Sea Eel, etc.	Sea Urchin	0
They're also friendlier here, especially the owner, Kenny.	owner	1
While the room is not particularly comfortable, once you're seated you'll forget about everything except what's on your plate.	room	1
I've lived in NYC all my life and had never before seen so many waterbugs in one place (except in a really bad dream).	waterbugs	-1
Winnie and her staff are the best crew you can find serving you.	staff	1
My host asked for appetizers for the group and the waiter gave us not only what we ordered, but some other items that were not ordered.	host	0
You can even get packages of the chutneys to stock your fridge!	chutneys	1
The bar has various selections and the mixed drink special is a catcher! 2 for 1's.	bar	1
If it isn't for the food (A+++), it must be the service or the ambience.	food	1
During the course of the past 3 months, the chef and staff changed and it was not for the better.	chef	-1
I like the ambience, it's very dark and original.	ambience	1
Overall, not worth the money.	money	-1
This place is not worth the prices.	prices	-1
We left after one drink.	drink	0
Pick a bagel has the best bagels in the city.	bagels	1
Yes you have to wait to be seated and because its small there is no waiting area and the seat at the bar was all taken.	wait	0
The last two times I ordered from here my food was soo spicy that  I could barely eat it, and the spice took away from the flavor of the dish.	food	-1
The fried dumplings are GREAT!	fried dumplings	1
This place has the best Chinese style BBQ ribs in the city.	BBQ ribs	1
Ive been here so many times the waiters know my name.	waiters	0
We figured we never had Argentinian Pizza before so we grabbed our lunch there, sharing a large Pelligrino, a pizza of two of their specials, one was goat cheese the other blue cheese, and both were excellent.	Argentinian Pizza	1
The 'kamasutra' and 'bombay cosmopolitan' are excellent and will have you tipsy in no time.	kamasutra	1
This is the perfect date spot for Williamsburg couples.	date spot	1
$6 and there is much tasty food, all of it fresh and continually refilled.	food	1
Just straight up cheap, good food.	food	1
Seating is ok even though sometimes there's alot of people.	Seating	0
Even with a relatively inexpensive botle of wine, if you can call $70.00 inexpensive, the cost is through the roof for better than average fare.	cost	-1
The steak was very fatty and the sauce was overpowering and not very tasty.	steak	-1
The food is alright - some stuff is good - some is not (like the steak dish which tends to be dry).	steak dish	-1
The staff was too busy ordering sushi for dinner and then laying it out to eat on the bar to even bring me my check.	staff	0
As a long-time patron of Mamoun's, I always figured that I had found the best late night food spot in the city.	food spot	1
Get the tuna of gari.	tuna	1
I like the somosas, chai, and the chole, but the dhosas and dhal were kinda dissapointing.	somosas	1
Edible but really a ripoff at those prices given whats in the area.	prices	-1
The staff has been nice, but they seemed really stressed and the unisex bathroom needs to be cleaned more often.	bathroom	-1
The service was the only thing good about this restaurant.	service	1
Service- friendly and attentive.	Service	1
Great food, great decor, great service.	food	1
And, atlhough tables opened up next to us and we ASKED for a slightly larger space, they left us awkardly seated.	tables	0
The palak paneer was standard, and I was not a fan of the malai kofta.	palak paneer	0
I've dined at Alain Ducasse's restaurant in Monte Carlo for half the price for the same excellent dining experience.	price	1
Yeah, sometimes the service can be slow.	service	-1
There was no ambiance.	ambiance	-1
Save your money and don't waste your calories, go to Margharita's on Washington Street instead, they have amazing food and the BEST service.	food	1
The service was attentive without being overbearing and each dish we tried was wonderful from the spring rolls to the cod with pineapple tempura.	service	1
The only weird thing was if we got a bottle, the waitress would have simply multiplied the glass price X4, which makes no sense whatsoever.	bottle	0
They sell special sushi, everything have a topping, sauce and etc.	sushi	1
DO not try unless you're just going there to hang out like the rest of the hipsters who apparently have no sense of taste.	taste	-1
The place is small and intimate and you may feel a little crowded, but the service is excellent and it's great for friends out, a romantic date, or a special occassion.	place	1
Service was also very good.	Service	1
I took my girlfriend there for her birthday last night and we had a relaxing, really good meal.	meal	1
I would not have been so disappointed with the portions if the qualities were good enough to make up for it, but they were not!	portions	-1
I'm happy to have Nosh in the neighborhood and the food is very comforting.	food	1
Good atmosphere, combination of all the hottest music dress code is relatively strict except on Fridays.	atmosphere	1
love the food.	food	1
I would highly recommend Nina's to anyone who wants to have a romantic dinner in a heart warming surrounding filled with candles and family pictures.	dinner	1
There's something smooth about sipping sake upper east side style.	sake	1
It's a nice place to relax and have conversation.	place	1
Wonderful strawberry daiquiries as well!	strawberry daiquiries	1
Going to Volare is like going to your favorite aunt's house for dinner, assuming that your aunt is a great Italian cook.	dinner	0
The sushi has been from average to below average, the wait service has always been sub-par the atmosphere goes from nice to really irritating (if you sit in the area beyond the kitchen, the acousitcs are horrid, everything echoes is extremely loud).	sushi	-1
Frites were delicious if a bit on the thick side.	Frites	1
Here you get the zen feel without feeling rigid.	zen feel	1
I would recommend putting your name down and then getting a drink at a local bar first though because of the wait time.	drink	0
I fell in love with the egg noodles in the beef broth with shrimp dumplings and slices of BBQ roast pork.	egg noodles in the beef broth with shrimp dumplings and slices of BBQ roast pork	1
I keep my fingers crossed the whole subway ride hoping that there will be a table I can sit at by myself and not have to share with the rice congee soup people.	table	0
Overall, the best bagel in town.	bagel	1
Light, refreshing summer rolls (not fried) remind me of Vietnamese places in Paris.	summer rolls	1
The sushi seemed pretty fresh and was adequately proportioned.	sushi	1
but the service was a bit slow.	service	-1
Spreads and toppings are great - though a bit pricey.	Spreads	1
When I saw that their website had a link to da Ciro in Napoli, I knew there was going to be good pizza!	pizza	1
No one asked what was wrong as we left with nothing touched on our plates.	plates	0
Indoor was very cozy and cute.	Indoor	1
We had a 3 hour brunch- they definitely do not rush you- and they kept the unlimited mimosas flowing the whole time.	brunch	1
And their prices are very high - they actually think that they can get away with charging such prices for such terrible food and service!	prices	-1
The service was excellent, the food was excellent, but the entire experience was very cool.	service	1
Just stick with the small dishes!	dishes	-1
The cafe itself was really nice with comfortable outdoor chairs and tables, but the service could have been better.	cafe	1
I've rarely had a problem with slow staff in the 10 years I've been going.	staff	1
Food is excellent.	Food	1
Although we were looking for regular lettuce and some walnuts the salads we got were great.	lettuce	1
Excellent lunch buffet for only $6.95.	lunch buffet	1
If you're not familiar with the cuisine, you may encounter problems ordering here and be sure to bring plenty of cash with you as they don't accept credit cards.	cuisine	-1
both are very reasonably priced (around $8 for dinner and $5 for lunch), and are delicious and filling.	priced	1
Ambience is so cute and quaint, good for business although we were there on vacation.	Ambience	1
The portion sizes here are huge, and the sushi is good.	portion sizes	1
My boyfriend ate tuna and it was cooked perfectly!	tuna	1
This wasn't the expected menu comprised only of pad thai and tom yum soup, but I thought that was what made the place so special.	menu	0
Good food at the restaurant (a bit expensive, but great if you want to impress your date).	food	1
I highly recommend Caviar Russe to anyone who wants delicious top grade caviar and fantastic service.	caviar	1
I have eaten there 3-4 times and the food was always good.	food	1
I wasn't thrilled to have to wait on line for thirty minutes, but I guess that's the price you pay for a popular place.	wait	-1
great eats, good times.	eats	1
Grilled whole fish wonderful, great spicing.	fish	1
For years, I thought Tuscan cuisine was the best, but Salvatore converted me to the hearty Neapolitan fare on my first visit.	Neapolitan fare	1
Plus, when our entrees were held up in the kitchen on a busy Saturday night, the owner sent over complimentary summer rolls to hold us over!	entrees	1
The service was great as well.	service	1
Try the lobster teriyaki and the rose special roll.	lobster teriyaki	1
Another plus is most of the entrees are approx.	entrees	1
The food was delicious, the atmosphere was relaxed, and we have now adopted Plate 347 as our Secret on Second!	food	1
From the moment we walked in they were more than accomodating even though the place was packed.	place	-1
I found the food, service and value exceptional everytime I have been there.	food	1
We ate at this Thai place following the reviews but very unhappy with the foods.	foods	-1
The food is definitely good, but I left a bit disappointed.	food	1
I am a 100 lb girl, had a glass of wine and a glass of beer prior to the dinner, and I was still HUNGRY after my visit to this place!	glass of wine	0
There is a downside if you're ordering in -- the delivery guys have MAJOR attitude.	delivery guys	-1
The all-Italian staff is warm and engaging from the start.	staff	1
The prices are exceptionally reasonable for food of this caliber.	prices	1
If you go here - your focus should be the Tamarind Margaritas.	Tamarind Margaritas	1
The filet mignon dish was superb!	filet mignon dish	1
This place is the most Japanese it can ever get.	place	1
The food is good, I can't lie.	food	1
great food, lt's of it, more then one person can eat!	food	1
I didn't expect to like Nosh as much as I did, but the pastrami on challah sandwich I had was otherworldly, the soups are like Mom's, and the knishes give Yonah Schimmel's a run for its money.	pastrami on challah sandwich	1
Cozy romantic atomosphere with only around 15 tables at most.	atomosphere	1
This place is worth going even if only for their beer.	beer	1
I really like both the scallops and the mahi mahi (on saffron risotto-yum!).	scallops	1
The ambience was so fun, and the prices were great, on top of the fact that the food was really tasty.	ambience	1
Do not get the Go Go Hamburgers, no matter what the reviews say.	Go Go Hamburgers	-1
The sandwhiches are out-of-this world!	sandwhiches	1
If you live in Upper Manhattan, Siam Square is THE place for Thia food.	Thia food	1
Decor is charming.	Decor	1
The food was very well prepared.	food	1
Really tasty spring rolls and noodles for a good price though.	spring rolls	1
Good, because hey, it's more food, but bad because dim sum is supposed to be smaller portions so you can try out more dishes and smaller so that each dish is cheap.	food	1
While most people can attest to spending over $50 on drinks in New York bars and hardly feeling a thing, the drinks here are plentiful and unique.	drinks	-1
The food arrived 20 minutes after I called, cold and soggy.	food	-1
If you go for the pre-theatre menu, it's an even greater deal.	pre-theatre menu	1
The prices cannot be beat for the quality, quantity, freshness and taste.	prices	1
Check it out, it won't hurt your stomach or your wallet.	stomach	1
Little Tonino's is just awesome, our favorite delivery place in Kennsington, honestly the best Gnochi I have ever had!	Gnochi	1
INCREDIBLY POOR SERVICE AN FOOD QUALITY AT EXORBITANT PRICES.	SERVICE	-1
I have been about 4 times and have always had a great meal.	meal	1
I go back in line like three times on average until I can't walk anymore.	line	-1
Horrible food and Horrible service.	food	-1
The wine and cheese plate are plentiful and can't wait to try the fondue or table grilling.	wine	1
They treated us well and the food was extremely fresh and well-prepared.	food	1
Their exotic salad is basic ly a delcious little green salad with a peanut sauce that is perfect before their sweet basil fried tofu.	exotic salad	1
THE BIG COMPLAINT: NO TOASTING AVAILABLE.	TOASTING	-1
Even if the food wasn't this good, the garden is a great place to sit outside and relax.	food	1
The food came out wrong, the waiter was no where to be found and the wine showed up at the end of the meal.	food	0
The chicken and steak were seasoned and cooked to perfection, and the lamb sandwhich is great for heartier appetites.	chicken	1
We saw them heating up at least one frozen item though I'm not sure which dim sum dish it was.	dim sum dish	-1
No you're going to go back because the food was good.	food	1
The food was great and the service was even better.	food	1
The fish is fresh and each piece is sliced to perfection and seasoned by the sushi chef (usually with a little fresh wasabi and soy sauce but also sometimes with some sea salt).	fish	1
Consequently, their burgers fell apart in their hands and made such a mess that they did'nt feel like finishing them.	burgers	-1
I really recommend the very simple Unda (Egg) rolls.	Unda (Egg) rolls	1
Very good wine choices.	wine choices	1
This is the only Thai place I go too in NYC, it's wonderful, and live relaxed Jazz on certain nights.	Jazz	1
We were seated and ignored by waitstaff.	waitstaff	-1
If you are in a big group, this place is perfect because it recomends sharing - they have lazy susans on most tables - even families can feel comfortable here.	lazy susans	1
They showed up 15 minutes after the tuna melt.	tuna	1
Tasty steak, pork loin, the works.	steak	1
I went with 5 friends and we lingered at the table for a bit and didn't feel rushed at all even though there was a wait.	table	0
I'd highly recommend it for a special occasion -- it provides and intimate setting and nice service.	setting	1
The burger was great, also.	burger	1
they did give a 15% discount at the end, wasn't enough, as they knew the service was horrible.	discount	-1
Just because it's cheap does NOT mean the portions are small or the food is nasty, IT IS GREAT!	portions	1
The pizza was great.	pizza	1
I had never had Edamame pureed before but I thought it was innovative and tasty (could've used a bit more salt).	Edamame pureed	1
however, it's the service that leaves a bad taste in my mouth.	service	-1
When we notified him that he didn't mention the specials, he didn't apologize but let us know that we made a very good decision regardless.	specials	0
The price was extremely reasonable for the appetizers and food we ate.	price	1
Don't dine at Tamarind for the vegetarian dishes, they are simply not up to par with the non-veg selections.	vegetarian dishes	1
Kenny the owner is always there and he treats my family like we are part of his family.	owner	1
They need a kick out of it but until then the sushi is pretty good and the place is consistent.	sushi	1
I've had to wait only a few times during lunch but this place is definitely worth the wait.	wait	1
All in all the food was above average and I would return to see how they operate with four or less dinners.	food	1
Delicious food, excellent service, and a pretty atmosphere make this a great choice for dinner and the $5.99 lunch buffet makes it an even better choice for lunch!	food	1
For appetizers, I recommend the shrimp fritters and dumplings.	appetizers	1
Such nice people working here - but I have to review the food.	people	1
The restaurant is dark and not very attractive and then you have spot lights shining on you putting you in the worst light possible, reaching for sunglasses.	spot lights	-1
Try the Times Square cocktail -- ginger lemonade with vodka (also available without vodka.)	Times Square cocktail	1
Veal Parmigana - Better than Patsy's!	Veal Parmigana	1
Great wine, great food.	wine	1
The service was mediocre, and the lack of air conditioning made for a less than comfortable meal.	service	0
The food and staff always surprise me with the new heights they are taken to.	food	1
Went to Ottimo and was expecting outstanding pizza (as I love La Pizza Fresca).	pizza	0
honestly the worst sushi my husband and i had in our entire lives.	sushi	-1
However, if you want great food at a great price and don't mind the decor, you can't beat this place.	food	1
Our tiny table for two (dinner plates hung over edge) was right in the middle of one of the lanes of waiter traffic.	table	-1
Sake collection was excellent (Try Nanbu Bijin), but pricy.	Nanbu Bijin	1
Interesting other dishes for a change include chicken in curry sauce and salmon caserole.	dishes	1
Ask for Usha, the nicest bartender in manhattan.	bartender	1
The place's decor and hidden bathrooms made for a good laugh.	decor	1
Its location is good and the fact that Hutner College is near and their prices are very reasonable, makes students go back to Suan again and again.	location	1
A wonderful place!	place	1
Deliveries often take up to an hour and the prices are higher than most other pizzerias in the area.	Deliveries	-1
Kind of a small place but I guess if they are not too busy might be able to fit a group or kids.	place	-1
We also ordered two hot dogs thinking they would be pretty good since there is a whole section on the menu devoted to them.	hot dogs	0
I've had the chicken with garlic sauce, chicken with black bean sauce, and hunan chicken.	chicken with garlic sauce	0
Because of the delicate thin crust, take-out pies get soggy in their boxes.	crust	-1
We got in line and were served while in line a bannan fritter.	served	0
It might have been a little too spicy for my friend, which you can couteract with eat more rice and keeping water on hand.	rice	0
This place is always very crowded and popular.	place	1
Appetizers are somewhere around $7 each and the main dishes are between $11 and $16.	Appetizers	0
My wife and I went to Orsay for Valentine's dinner.	dinner	0
I don't know about you guys, but when I go somewhere to eat I go for the food not for the atmosphere.	food	0
A gentleman, maybe the manager, came to our table, and without so much as a smile or greeting asked for our order.	manager	0
we were tired and cold when we got to the restaurant, then we sat down to begin ordering appetizers.	appetizers	0
I've had pizza both times and the caprese salad appetizer.	pizza	0
He was terribly thirsty after the meal too.	meal	-1
The selection changes frequently but the basic dishes are always available.	selection	0
Get the soup and a nosh (pastrami sandwich) for $8 and you're golden.	soup	1
I have to say that if this what makes it easier to get a saet a lunch- I dont mind.	lunch	0
My family and I ate here last night for our annual Christmas dinner with the family members who would rather spend the holidays with friends out-of-town.	Christmas dinner	0
I grew up on these bagels.	bagels	1
We were told that they were booked solid and no other table was available.	table	-1
To my right, the hostess stood over a busboy and hissed rapido, rapido as he tried to clear and re-set a table for six.	hostess	0
After dealing with subpar pizza all over the Kensington neighborhood - I've found little toninos.	pizza	-1
they were able to squeeze me in at 6 after i called the night before my anniversary for a friday night reservation and told me they'd treat us well for the occasion.	reservation	0
Note that they do not serve beer, you must bring your own.	beer	-1
We ate outside at Haru's Sake bar because Haru's restaurant next door was overflowing.	bar	0
The service was typical short-order, dinner type.	service	0
We shared a bottle of sake, an order of edamames, and she had the sushi plate while I had the sashimi.	bottle of sake	0
I can't believe people complain about no cheese sticks?	cheese sticks	0
From the appetizers we ate, the dim sum and other variety of foods, it was impossible to criticize the food.	appetizers	1
Each table has a pot of boiling water sunken into its surface, and you get platters of thin sliced meats, various vegetables, and rice and glass noodles.	table	0
