review	aspect	sentiment
I charge it at night and skip taking the cord with me because of the good battery life.	cord	1
"The tech guy then said the service center does not do 1-to-1 exchange and I have to direct my concern to the ""sales"" team, which is the retail shop which I bought my netbook from."	tech guy	0
it is of high quality, has a killer GUI, is extremely stable, is highly expandable, is bundled with lots of very good applications, is easy to use, and is absolutely gorgeous.	quality	1
Easy to start up and does not overheat as much as other laptops.	start up	1
I even got my teenage son one, because of the features that it offers, like, iChat, Photobooth, garage band and more!	features	1
Great laptop that offers many great features!	features	1
One night I turned the freaking thing off after using it, the next day I turn it on, no GUI, screen all dark, power light steady, hard drive light steady and not flashing as it usually does.	GUI	0
In the shop, these MacBooks are encased in a soft rubber enclosure - so you will never know about the razor edge until you buy it, get it home, break the seal and use it (very clever con).	rubber enclosure	1
However, the multi-touch gestures and large tracking area make having an external mouse unnecessary (unless you're gaming).	multi-touch gestures	1
The speed is incredible and I am more than satisfied.	speed	1
This laptop meets every expectation and Windows 7 is great!	Windows 7	1
I can barely use any usb devices because they will not stay connected properly.	usb devices	-1
When I finally had everything running with all my software installed I plugged in my droid to recharge and the system crashed.	software	0
One suggestion I do have, is to not bother getting Microsoft office for the mac expecting it will work just like you knew it to on a PC.	Microsoft office for the mac	-1
"I also got the added bonus of a 30"" HD Monitor, which really helps to extend my screen and keep my eyes fresh!"	"30"" HD Monitor"	1
The machine is slow to boot up and occasionally crashes completely.	boot up	-1
After paying several hundred dollars for this service, it is frustrating that you cannot get help after hours.	service	-1
I love the operating system and the preloaded software.	operating system	1
The best thing about this laptop is the price along with some of the newer features.	price	1
After numerous attempts of trying (including setting the clock in BIOS setup directly), I gave up(I am a techie).	clock in BIOS setup	-1
YOU WILL NOT BE ABLE TO TALK TO AN AMERICAN WARRANTY SERVICE IS OUT OF COUNTRY.	WARRANTY SERVICE	-1
but now i have realized its a problem with this brand.	brand	-1
I was looking for a mac which is portable and has all the features that I was looking for.	features	1
Also kinda loud when the fan was running.	fan	-1
There also seemed to be a problem with the hard disc as certain times windows loads but claims to not be able to find any drivers or files.	hard disc	0
Drivers updated ok but the BIOS update froze the system up and the computer shut down.	Drivers	1
Spent 2 hours on phone with HP Technical Support.	HP Technical Support	0
Speaking of the browser, it too has problems.	browser	-1
The keyboard is too slick.	keyboard	-1
Nightly my computer defrags itself and runs a virus scan.	virus scan	0
It's like 9 punds, but if you can look past it, it's GREAT!	9 punds	-1
It's just as fast with one program open as it is with sixteen open.	program	0
Still under warrenty so called Toshiba, no help at all.	warrenty	-1
I was happy with My purchase of a Toshiba Satellite L305D-S5934 laptop until it came time to have it repaired under the Toshiba Warranty.	Toshiba Warranty	-1
The fact that you can spend over $100 on just a webcam underscores the value of this machine.	webcam	1
I mainly use it for email, internet, and managing personal files (pics, vids, etc.).	internet	0
A month or so ago, the freaking motherboard just died.	motherboard	-1
The system it comes with does not work properly, so when trying to fix the problems with it it started not working at all.	system	-1
Then after 4 or so months the charger stopped working so I was forced to go out and buy new hardware just to keep this computer running.	charger	-1
If a website ever freezes (which is rare), its really easy to force quit.	force quit	1
It rarely works and when it does it's incredibly slow.	works	-1
I also enjoy the fact that my MacBook Pro laptop allows me to run Windows 7 on it by using the VMWare program.	Windows 7	1
It's so much easier to navigate through the operating system, to find files, and it runs a lot faster!	navigate	1
Purchased a Toshiba Lap top it worked good until just after the warrenty went out.	warrenty	-1
I wanted to purchase the extended warranty and they refused, because they knew it was trouble.	extended warranty	0
The reality was, it heated up very quickly, and took way too long to do simple things, like opening my Documents folder.	opening my Documents folder	-1
I had always used PCs and been constantly frustrated by the crashing and the poorly designed operating systems that were never very intuitive.	operating systems	-1
Then, within 5 months, the charger crapped out on me.	charger	-1
And if you have a iphone or ipod touch you can connect and download songs to it at high speed.	speed	1
I love the glass touchpad.	glass touchpad	1
I continued to take the computer in AGAIN and they replaced the hard drive and mother board yet again.	hard drive	-1
I am using the external speaker- sound is good.	external speaker sound	1
still testing the battery life as i thought it would be better, but am very happy with the upgrade.	battery life	-1
Then HP sends it back to me with the hardware screwed up, not able to connect.	hardware	-1
Oh yeah, don't forget the expensive shipping to and from HP.	shipping	-1
Everything is so easy to use, Mac software is just so much simpler than Microsoft software.	use	1
And if you do a lot of writing, editing is a problem since there is no  forward delete  key.	editing	-1
Its ease of use and the top service from Apple- be it their phone assistance or bellying up to the genius bar- cannot be beat.	use	1
It has a 10 hour battery life when you're doing web browsing and word editing, making it perfect for the classroom or office, and in terms of gaming and movie playing it'll have a battery life of just over 5 hours.	battery life	1
Acer has set me up with FREE recovery discs, when they are available since I asked.	recovery discs	1
"I also purchased Office Max's ""Max Assurance"" with the ""no lemon"" clause."	"Office Max's ""Max Assurance"""	0
I eventually did the migration from my iMac backup disc which uses USB.	iMac backup disc	0
The battery life seems to be very good, and have had no issues with it.	battery life	1
Enabling the battery timer is useless.	battery timer	-1
Temperatures on the outside were alright but i did not track in Core Processing Unit temperatures.	Temperatures	0
Going to bring it to service today.	service	0
There is no need to purchase virus protection for Mac, which saves me a lot of time and money.	virus protection for Mac	1
But we had paid for bluetooth, and there was none.	bluetooth	-1
So, I paid a visit to LG notebook service center at Alexandra Road, hoping they can make the hinge tighter.	LG notebook service center	0
My daughter uses it for games, email, facebook, pictures and music.	games	0
It is always reliable, never bugged and responds well.	responds	1
After about a week I finally got it back and was told that the motherboard had failed and so they installed a new motherboard.	motherboard	-1
It was slow, locked up, and also had hardware replaced after only 2 months!	hardware	-1
they had to replace the motherboard in April	motherboard	-1
Yes, the computer was light weight, less expensive than the average laptop, and was pretty self explantory in use.	use	1
Also, if you need to talk to a representive at Microsoft, there is a charge, which I believe is robbery, since you are charged enormous amounts for a very badly designed system, which most people would have went with XP if they could.	representive at Microsoft	1
I love WIndows 7 which is a vast improvment over Vista.	WIndows 7	1
Keyboard is great, very quiet for all the typing that I do.	Keyboard	1
Dell's customer disservice is an insult to it's customers who pay good money for shoddy products.	Dell's customer disservice	-1
It had a cooling system malfunction after 10 minutes of general use, and would not move past this error.	cooling system	0
I can render AVCHD movies with little effort, which was a problem for most pc's unless you had a quad core I7.	quad core I7	1
After talking it over with the very knowledgeable sales associate, I chose the MacBook Pro over the white MacBook.	sales associate	1
If you really want a bang-up system and don't need to run Windows applications, go with an Apple;	system	1
You won't have to spend gobs of money on some inefficient virus program that needs to be updated every month and that constantly drains your wallet.	virus program	-1
2 months later, the battery went.	battery	-1
You may need to special order a bag.	bag	0
It's color is even cool.	color	1
keys are all in weird places and is way too large for the way it is designed.	keys	-1
Yes, a Mac is much more money than the average laptop out there, but there is no comparison in style, speed and just cool factor.	style	1
The keyboard feels good and I type just fine on it.	keyboard	1
I thought the white Mac computers looked dirty too quicly where you use the mousepad and where you place your hands when typing.	mousepad	0
BEST BUY - 5 STARS + + + (sales, service, respect for old men who aren't familiar with the technology) DELL COMPUTERS - 3 stars DELL SUPPORT - owes a me a couple	sales	1
no complaints with their desktop, and maybe because it just sits on your desktop, and you don't carry it around, which could jar the hard drive, or the motherboard.	hard drive	0
Yes, they cost more, but they more than make up for it in speed, construction quality, and longevity.	speed	1
"Since I keyboard over 100 wpm, I look for a unit that has a comfortble keyboard (no keys sticking or lagging, strange configuration of ""extra key"", etc."	keyboard	1
) I also tried the touch pad and compared it to other netbooks in the store.	touch pad	0
It gets stuck all of the time you use it, and you have to keep tapping on it to get it to work.	use	-1
lots of preloaded software.	preloaded software	1
I wish it had a webcam though, then it would be perfect!	webcam	-1
My favorite part of this computer is that it has a vga port so I can connect it to a bigger screen.	vga port	1
Another thing I might add is the battery life is excellent.	battery life	1
One drawback, I wish the keys were backlit.	keys	-1
Acer was no help and Garmin could not determine the problem(after spending about 2 hours with me), so I returned it and purchased a Toshiba R700 that seems even nicer and I was able to load all of my software with no problem.	software	1
I play a lot of casual games online, and the touchpad is very responsive.	touchpad	1
Granted, it's still a very new laptop but in comparison to my previous laptops and desktops, my Mac boots up noticeably quicker.	boots up	1
It caught a virus that completely wiped out my hard drive in a matter of hours.	hard drive	-1
It is everything I'd hoped it would be from a look and feel standpoint, but somehow a bit more sturdy.	look and feel standpoint	1
The Bluetooth was not there at all, and the fingerprint reader driver would be there, but the software would hang after installation was 1/2 way done.	Bluetooth	-1
The delivery was fast, and I would not hesitate to purchase this laptop again.	delivery	1
I've been impressed with the battery life and the performance for such a small amount of memory.	battery life	1
It's applications are terrific, including the replacements for Microsoft office.	applications	1
I got it back and my built-in webcam and built-in mic were shorting out anytime I touched the lid, (mind you this was my means of communication with my fiance who was deployed) but I suffered thru it and would constandly have to reset the computer to be able to use my cam and mic anytime they went out.	built-in webcam	-1
Is this partially due to the fact that it is running Windows Vista?	Windows Vista	0
The board has a bad connector with the power supply and shortly after warrenty expires the power supply will start having issues.	board	-1
My dad has one of the very first Toshibas ever made, yes its abit slow now but still works well and i hooked to my ethernet!	works	1
Mostly I love the drag and drop feature.	drag and drop feature	1
oh yeah, and if the fancy webcam breaks guess who you have to send it to to get it fixed?	webcam	-1
I ordered through MacMall, which saved me the sales tax I would have incurred buying locally.	sales tax	1
Of course, I also have several great software packages that came for free including iWork, GarageBand, and iMovie.	software packages	1
The screen is very large and crystal clear with amazing colors and resolution.	screen	1
After a little more than a year of owning my MacBook Pro, the monitor has completely died.	monitor	-1
The brand of iTunes has just become ingrained in our lexicon now, but keep in mind that Apple started it all.	iTunes	1
Size: I know 13 is small (especially for a desktop replacement) but with an external monitor, who cares.	Size	0
Taking it back to Best Buy I found that a tiny plastic piece inside had broken (manuf issue).	manuf	-1
The display is incredibly bright, much brighter than my PowerBook and very crisp.	display	1
The AMD Turin processor seems to always perform so much better than Intel.	AMD Turin processor	1
After that the said it was under warranty.	warranty	0
The start menu is not the easiest thing to navigate due to the stacking.	start menu	-1
Only thing I would want to add to this is an internal bluray read/write drive.	bluray read/write drive	-1
The service tech said he had tried to duplicate the damage and wasn't able to recreate it therefore it had to be their defect.	service tech	-1
The tech store I purchased this from sent it back,,,,,eventually I got a new or repaired machine approximately 3 weeks later.	tech store	-1
Really like the textured surface which shows no fingerprints.	surface	1
The screen is bright and the keyboard is nice;	screen	1
But the machine is awesome and iLife is great and I love Snow Leopard X.	iLife	1
I thought learning the Mac OS would be hard, but it is easily picked up if you are familiar with a PC.	Mac OS	1
"I had static in the output, and I had to reduce the sound output quality to ""FM"" as opposed to the default ""CD."	sound output quality	-1
I custom ordered the machine from HP and could NOT understand the techie due to his accent.	techie	-1
It is easy to use and lightweight.	use	1
I went to Toshiba online help and found some suggestions to fix it.	Toshiba online help	1
They also have a longer service life than other computers (I have several friends who still use the older Apple PowerBooks).	service life	1
If you check you will find the same notebook with the above missing ports and a dual core AMD or Intel processor.	ports	0
This laptop is a great price and has a sleek look.	price	1
I especially like the keyboard which has chiclet type keys.	keyboard	1
Runs Hot  I thought we were paying for quality in our decision to buy an Apple product.	quality	-1
For the not so good, I got the stock screen - which is VERY glossy.	stock screen	-1
The gray color was a good choice.	gray color	1
I would like to have volume buttons rather than the adjustment that is on the front.	volume buttons	-1
I bought a protector for my key pad and it works great :)	protector	1
The magnetic plug-in power charging power cord is great (I even put it to the test by accident)- excellent innovation!	magnetic plug-in power charging power cord	1
It seems they could have updated XP and done without creating Vista.	XP	1
It is easy to use, fast and has great graphics for the money.	use	1
I like how the Mac OS is so simple and easy to use.	Mac OS	1
While Apple's saving grace is the fact that they at least stand behind their products, and their support is great, it would be nice if their products were more reliable to justify the premium.	support	1
I was ready to take it back for a refund, but the Geek Squad camed through and pointed me in the right direction to get it fixed.	Geek Squad	1
only good thing is the graphics quality.	graphics quality	1
The other lock-up problems are from a myriad of causes, the most common being a corrupted version of Appleworks which can render the browser useless.	Appleworks	-1
The paint wears off easily due to the keyboard being farther back than usual.	paint	-1
I had purchased it from a major electronics store and took it to their service department to find out what the problem was.	service department	0
The store honored their warrenty and made the comment that they don't even recommend the HP brand because of the problems with their warrentys.	warrenty	1
I always use a backup hard disk to store important files at all times.	hard disk	0
But the screen size is not that bad for email and web browsing.	screen size	1
Once I removed all the software the laptop loads in 15-20 seconds.	software	0
On my PowerBook G4 I would never use the trackpad I would use an external mouse because I didn't like the trackpad.	trackpad	0
This computer doesn't do that well with certain games it can't play some and it becomes too hot while playing games.	games	-1
"Obviously one of the most important features of any computer is the ""human interface."	features	0
The body is a bit cheaply made so it will be interesting to see how long it holds up.	body	-1
The i5 blows my desktop out of the water when it comes to rendering videos.	i5	-1
With a mac you don't have to worry about antivirus software or firewall, it's so wonderful.	antivirus software	0
Am very glad I bought it, great netbook, low price.	price	1
The Apple team also assists you very nicely when choosing which computer is right for you :)	Apple team	1
The video chat is the only thing that is iffy about it but im sure once they unpdate the next version on the macbook book the quality of it will be better.	video chat	-1
Fan vents to the side, so no cooling pad needed, great feature!	Fan	1
i use my mac all the time, i love the software, the way it takes a short time to load things, how easy it is to use and most of all how you don't have to worry about viruses.	software	1
Wasted me at least 8 hours of installation time.	installation time	-1
It has far exceeded my expectations for power, storage, and abilitiy.	power	1
A great feature is the spotlight search: one can search for documents by simply typing a keyword, rather than parsing tens of file folders for a document.	feature	1
My wireless system would not recognize Windows 7 and I couldn't get online to find out why.	wireless system	0
I am enjoying it and the quality it provides is great!	quality	1
Suffice it to say, my MacBook Pro keeps me going with its long battery life and blazing speed.	battery life	1
The OS is also very user friendly, even for those that switch from a PC, with a little practice you can take full advantage of this OS!	OS	1
iTunes is a handy music-management program, and it is essential for anyone with an iPod.	iTunes	1
Mac is not made for gaming.	gaming	-1
Well I spilled something on it and they replaced it with this model, which gets hot and the battery doesn't make it through 1 DVD.	battery	-1
I've had to call Apple support to set up my new printer and have had wonderful experiences with helpful, english speaking (from Vancouver) techs that walked me through the processes to help me.	Apple support	1
But Sony said we could send it back and be charged for adding the bluetooth an additional seventy something dollars.	adding the bluetooth	-1
I need graphic power to run my Adobe Creative apps efficiently.	graphic power	0
the programs are esay to use and are quick to process this computer works like a charm.	programs	1
The materials that came with the computer did not include the right # anywhere.	materials	-1
It does not even have the software to play a dvd now.	software	-1
HOW DOES THE POWER SUPPLY NOT WORK!!!	POWER SUPPLY	-1
Sells for the same as a netbook without sacrificing size.	size	1
Windows XP SP2 caused many problems on the computer, so I had to remove it.	Windows XP SP2	-1
I reloaded with Windows 7 Ultimate, and the Bluetooth and Fingerprint reader (software) would not load.	Windows 7 Ultimate	-1
None of the techs at HP knew what they were doing.	techs at HP	-1
this is my second one and the same problem, bad video card  unreliable overall, this will be my second time returning this laptop back to best buy.	video card	-1
With awesome graphics and assuring security, it's perfect!	graphics	1
It runs perfectly.	runs	1
Sometimes the screen even goes black on this computer.	screen	-1
I recommend for word processing and internet users.	word processing	1
Since I've had this computer I've only used the trackpad because it is so nice and smooth.	trackpad	1
A longer battery life would have been great - but it meets it's spec quite easily.	spec	1
Who couldn't love a DVD burner, 80-gigabyte HD, and fairly new graphics chip? As I soon discovered, though, there is a reason for which similarly-configured Sony and Toshiba machines cost more: they use higher-quality components that are faster, better-configured, and end up lasting a lot longer.	DVD burner	1
Its fast and another thing I like is that it has three USB ports.	USB ports	1
The salesman talked us into this computer away from another we were looking at and we have had nothing but problems with software problems and just not happy with it.	software	-1
That system is fixed.	system	0
The computer itself was fast, ran smoothly, and had no problems.	ran	1
Like the price and operation.	price	1
The brand is tarnished in my heart.	brand	-1
This is likely due to poor grounding and isolation between the components, and I'm hoping that it can be fixed with a ground loop isolator, but I still expected better product quality for this price range.	components	0
I 'have had it for about a 1 1/2 and yes I have had an issue with it one month out of warranty.	warranty	0
Once open, the leading edge is razor sharp.	leading edge	-1
Loaded with bloatware.	bloatware	0
Maximum sound isn't nearly as loud as it should be.	Maximum sound	-1
Great Laptop for the price, works well with action pack games.	price	1
Although the price is higher then Dell laptops, the Macbooks are worth the dough.	price	-1
I would not recommend this to anyone wanting a notebook expecting the performance of a Desktop it does not meet the expectations.	performance	-1
The Macbook arrived in a nice twin packing and sealed in the box, all the functions works great.	twin packing	1
So what if the laptops/mobile phones look chic and cool? The after sales support is terrible.	look	1
I also like the acer arcade but these were reallythe only two things I liked about this laptop.	acer arcade	1
Have not yet needed any customer support with this yet so to me that is a great thing, which is leaps and bounds ahead of PC in my opinion.	customer support	1
I gave it to my daughter because I just hated the screen, hated that it had no cd drive to at least play cd's when I wanted to listen to music and do schoolwork.	screen	-1
It runs very quiet too which is a plus.	runs	1
but it  has a major design flaw.	design	-1
It was heavy,bulky, and hard to carry because of the size.	size	-1
The games included are very good games.	games	0
I had something else go wrong and they said it had to be in good working order to be able to buy the warranty.	warranty	-1
Sometimes you really have to tap the pad to get it to worki	pad	-1
It's super fast and a great value for the price!	value	1
Three, the mac book has advantages over pcs' with linux based os there is very 'few problems with system performance when it comes to a mac.	linux based os	-1
A mac is very easy to use and it simply makes sense.	use	1
however, I may have inadvertently thrown out one of the batteries with the shipping carton.	batteries	0
It is so much easier to use	use	1
There is no need to open a program first and the cliick open or import.	program	1
It is so nice not to worry about that and the extra expense that comes along with the necessary virus protection on PC's.	virus protection	1
Three weeks after I bought the netbook, the screen quit working.	screen	-1
The processor screams, and because of the unique way that Apple OSX 16 functions, most of the graphics are routed through the hardware rather than the software.	processor	1
I wanted something that had a new Intel Core processors and HDMI port so that we could hook it up directly to our TV.	Intel Core processors	0
With today's company fighting over marketshare, its a shame that ASUS can get away with the inept staff answering thephone.	staff	-1
The price premium is a little much, but when you start looking at the features it is worth the added cash.	price premium	1
Microsoft word was not on it andI had to buy it seperately.	Microsoft word	-1
it has 3 usb ports, 1 sd memory card reader and an sd memory car expansion.	usb ports	0
I connect a LaCie 2Big external drive via the firewire 800 interface, which is useful for Time Machine.	LaCie 2Big external drive	1
My Toshiba did not have sound on everything, just certain things.	sound	-1
I am overall very pleased with my toshiba satellite, I like the extra features, I love the windows 7 home premium.	extra features	1
The Aspire wont even boot past the Acer screen with a Droid (I have tried both Motorola and HTC) plugged into the USB port.	boot	-1
The battery life was shorter than expected.	battery life	-1
It fires up in the morning in less than 30 seconds and I have never had any issues with it freezing.	fires up	1
The keyboard is top notch.	keyboard	1
It drives me crazy when I want to download a game or something of that nature and I can't play it because its not compatable with the software.	software	-1
The online tutorial videos make it super easy to learn if you have always used a PC.	online tutorial videos	1
With a MAC computer I have more free time as I don't have to wait for windows to boot up or shut down and all the viruses associated with windows.	windows	-1
It was very easy to just pick up and use-- It did not take long to get used to the Mac OS.	use	1
It is well worth the money it cost, Very good investment.	cost	1
Upgrading from Windows 7 Starter, thru Windows 7 Home Premium, to Windows 7 Professional was a snap;	Windows 7 Starter	0
This computer had exactly the specifications I needed.	specifications	1
My kids (and dogs) destroyed two power cords by pulling on them.	power cords	0
I had upgraded my old MacBook to Lion, so I kind of knew what I was getting, but hadn't been able to enjoy some of the awesome new multi-touch features.	multi-touch features	1
The screen is a little glary, and I hated the clicking buttons, but I got used to them.	screen	-1
Not to mention, the battery life is absolutely amazing.	battery life	1
Windows also shuts the computer down for no reason without warning.	Windows	-1
not using wired lan not sure what thats about.	wired lan	0
Anyways I bought this two months ago and when I first brought it home it kept giving me a message about a vibration in the hard drive and it is putting it temporaly in save zone.	hard drive	-1
It's fast and has excellent battery life.	battery life	1
Apple care included.	Apple care	0
Features like the font are very block-like and old school.	Features	-1
It is loaded with programs that is of no good for the average user, that makes it run way to slow.	programs	-1
I feel that it was poorly put together, because once in a while different plastic pieces would come off of it.	plastic pieces	-1
Finally, I should note that I took the 2GB RAM stick from my old EeePC and installed it before I even powered on for the first time.	2GB RAM stick	0
Windows is also rather unsteady on its feet and is susceptible to many bugs.	Windows	-1
After sending out documents via email and having recipients tell me they could not open the documents or they came through as gibberish, I broke down and spent another $100 to get Microsoft Word for Mac.	Microsoft Word for Mac	0
DO NOT BUY GATEWAY COMPUTERS THEY ARE JUNK AND THE WARRANTY COMPANY IS HORRIBLE.	WARRANTY COMPANY	-1
then on top of it all their cusromer service center is in the middle east.	cusromer service center	-1
The only bad part is the size/weight.	size	-1
The little battery that it did have would only last about an hour while just having it on the desktop.	battery	-1
I liked the aluminum body.	aluminum body	1
Its good for playing my apps on Facebook or watching movies.	playing	1
From the build quality to the performance, everything about it has been sub-par from what I would have expected from Apple.	build quality	-1
I love the dock where I can simply drop a file ontop of a particular program, and the program will simply open that file.	dock	1
pretty much everything else about the computer is good it just stops working out of no were.	working	-1
It was truly a great computer costing less than one thousand bucks before tax.	costing	1
Now,,,,,my monitor has been acting up for about 2 months.	monitor	-1
Also, the extended warranty was a problem.	extended warranty	-1
Boots up fast and runs great!	Boots up	1
Lightweight and the screen is beautiful!	screen	1
I needed a driver for my HP and they would not help me with out me paying over $50 for it.	driver	0
Call tech support, standard email the form and fax it back in to us.	tech support	0
They sent it back with a huge crack in it and it still didn't work.	work	-1
A coupla months later, they change my hard drive.	hard drive	-1
They say sorry out of warranty.	warranty	-1
I bought this laptop because of the performance to price ratio.	performance	1
PC never worked right even after BIOS fixed.	BIOS	-1
After having two PC laptops die with in the past 3 years, I was led to the Apple display at Best Buy by the sleek design and promise of less tech issues.	design	1
The size is perfect and I do not recomend anything bigger except for any person who can exceed the limited space it gives you.	size	1
The service I received from Toshiba went above and beyond the call of duty.	service	1
Have had many higher priced computers crash and burn long before ever got to use all that great memory and speed, etc.	priced	-1
I would recommend it just because of the internet speed probably because thats the only thing i really care about.	internet speed	1
There are several programs for school or office use (Pages, Numbers, Keynote, etc.), music (Garageband), photo management (Photo Booth, iPhoto), video-editing or movie-making (iMovie), etc.	programs	0
The screen shows great colors.	screen	1
I have no idea how to burn cd's or to use the web cam, just for starters.	burn cd's	0
The 17 inch screen is very large, but the computer is very light.	17 inch screen	-1
My opinion of Sony has been dropping as fast as the stock market, given their horrible support, but this machine just caused another plunge.	support	-1
For the Bluetooth to work properly, you must install the Launch Manager on the Drivers/Applications DVD, or it will not show after the reload.	Bluetooth	0
I also liked the glass screen.	glass screen	1
The switchable graphic card is pretty sweet when you want gaming on the laptop.	switchable graphic card	1
It's not a wear-and-tear issue, not due to user carelessness and most importantly, they CAN'T guarantee the problem will be solved if it is sent for service and I have to accept the outcome.	service	-1
The battery life has not decreased since I bought it, so i'm thrilled with that.	battery life	1
When I called Toshiba, they would not do anything and even tried to charge me $35 for the phone call, even though they didn't offer any technical support.	technical support	-1
I bought this notebook and only had it for 3 months If it is overload with updates the BOOT MGR.	BOOT MGR	0
Oh and if thats not bad enough it doesn't come with a recovery cd so you can make one if you know how to or buy one if you buy it the cost is $25 for two cds.	recovery cd	-1
The price and features more than met my needs.	price	1
Skype is just so dang cool with this machine too.	Skype	1
the mouse buttons are hard to push.	mouse buttons	-1
Also, HDD secures inside using rails, and there is only one set on the main hard drive.	HDD	1
All I will say now is that it was over two grand less expensive and so much better quality than my hunk of crap Vaio.	quality	1
(Beware, their staff could send you back making you feel that only they know what a computer is.	staff	-1
My sister has the same Mac as me and she is in a band and uses GarageBand to record and edit.	GarageBand	0
They say that this will invalidate the warranty on the hard drive (I don't really understand why but anyway).	warranty	0
and looks very sexyy:D  really the mac book pro is the best laptop specially for students in college if you are not caring about price.	price	-1
A great computer for light home use and business use.	home use	1
Also consider the MS Office apps are all trial versions, hope you have your own copies.	MS Office apps	-1
The battery life is amazingly long at 7hrs and 5hrs if you use it.	battery life	1
lightweight, long battery life, excellent transition from PC;	battery life	1
The price is another driving influence that made me purchase this laptop.	price	1
The Nortons virus scan is only for a very short time unlike others that usually are good for a year.	Nortons virus scan	-1
It is stamped and not in pieces therefore it is a stronger more resilient frame.	frame	1
I am first time Mac Buyer and am amazed at features and ease of use the Mac offers.	features	1
Came fully loaded - good.	loaded	1
I noticed windows has a new system called Windows 7, what about us Vista users?  They should get all the bugs out of Vista before investing in a new system.	windows	0
When we bought our new HP comouter in Dec. of 2008, we wanted Windows XP, but were told it would cost an extra $159, so we went with Vista.	Vista	0
The only thing that I have, is the key broad is a little dark to see the letters, would help if it was a little lighter then it is.	key broad	-1
"I'm still within the one year warranty but the repair ""depot""  has deemed that this time it was caused by physical abuse and is not  covered."	warranty	-1
But I needed a laptop for school use.	school use	0
This is the complete opposite to an ergonomic design.	design	-1
I would like at least a 4 hr. battery life.	battery life	0
The only thing that I don't like about my mac is that sometimes there are programs that I want to be able to run and I am not able to.	programs	-1
Wireless has not been a issue for me, like some others have meantioned.	Wireless	1
MacBook Notebooks quickly die out because of their short battery life, as well as the many background programs that run without the user's knowlede.	battery life	-1
All the things you can do with the trackpad make navigating around the computer and its programs so much simpler, quicker, and easier.	trackpad	1
I guess the only good thing that came out of these were the speakers and the subwoofer.	speakers	1
Theres a built in camera with special effects- for video and photography.	built in camera	1
All for such a great price.	price	1
Long story short, since I experience so many problems with my laptop every since I bought it from day one, I didn't ask for a new laptop or a refund of what I pay for a crapy laptop, but just an extension of my laptop warranty for another year, they made a big deal of out that and after so many calls and complaints about their products and services, they finally gave in.	warranty	0
Another thing is that after only a month the left mouse key broke and it costed $175 to send it in to fix it.	left mouse key	0
Clear picture on it and everything.	picture	1
They said that my computer was covered on an extended warranty, and that products with  extended warranties are taken care of through third parties and not Sony itself anymore.	extended warranty	0
Very long-life battery (up to 10-11 hours depending on how you configure power level settings).	battery	1
Screen is awesome, battery life is good.	Screen	1
The black model also has a very nice seamless appearance - one of the better looking notebooks I've seen.	appearance	1
The technical service for dell is so 3rd world it might as well not even bother.	technical service for dell	-1
The graphics were awful and the warranty isn't even worth the cheap payment on the computer.	graphics	-1
They gave me a hard time yet again, but their was a malfunction in the battery itself, it didn't die.	battery	-1
If you don't feel comfortable doing it yourself, just buy the case and be happy, plus it looks nice, I bought the white one from Best Buy.	case	1
you can find many laptops with the same performance and even better with lower price, but you cannot find the look, easy, applications, and the experience in mac.	performance	1
Excellent speed for processing data.	speed	1
When you call tech support you were routed to someone who was in another country and did not know what they were doing.	tech support	-1
I was taught to use Photoshop and was amazed.	Photoshop	1
Somehow the system clock got messed up after reboot.	system clock	-1
the only problem is that i had to add 1 gb RAM, the computer was kinda slow.	RAM	-1
The driver updates don't fix the issue, very frustrating.	driver updates	-1
I will never go back to Windows!	Windows	-1
It works really well.	works	1
Bigger HD, better graphics card, and a bid HD.	HD	1
The built in camera is very useful when chatting with other techs in remote buildings on our campus.	built in camera	1
Mine came at $1,700 w/o a DVD burner (!).	DVD burner	-1
The DVD burner broke after burning 3 DVD'd during that time!	DVD burner	-1
It works fine with our wireless and they've had not problems.	works	1
But you must get the 15 inch.	15 inch	1
Overall the computer is very easy to use, the screen is perfect, great computer, my daughter loves.	use	1
The casing of the power cord fried and shocked my husband when he pulled it out of the socket.	casing of the power cord	-1
It does not keep internet signals no matter where you bring it.	internet signals	-1
It's a great product for a great price!	price	1
Again, the same problem, the right speaker did not work.	right speaker	-1
But see the macbook pro is different because it may have a huge price tag but it comes with the full software that you would actually need and most of it has free future updates.	software	1
and the multiple page viewer ( allows you to press one button to see every separate page currently opened at the same time in one screen) are great for those who are working non stop or just shopping online.	multiple page viewer	1
This was the 3rd day and part still had not been shipped.	shipped	-1
Keyboard good sized and wasy to use.	Keyboard	1
HP said it was out of warranty.	warranty	0
I never had this kind of quality issue with Dell (not to say Dell is that great), not with a brand new laptop.	quality	-1
wonderful features.	features	1
I had to call HP and ask for a recovery disk because the computer does not come with one and completely redo it all.	recovery disk	-1
Im glad that it has such great features in it.	features	1
I like those programs better than Office and you can save your files to be completely compatible with the Office programs as well.	programs	1
Great wifi too.	wifi	1
WHEN TYPING, LETTERS AND SPACES ARE FREQUENTLY OMITTED REQUIRING THE USER TO REDO MANY WORDS AND SENTENCES.	TYPING	-1
Only a few days after I received the computer back, the screen froze again.	screen	-1
It is not ideal for children because of the temp.	temp	-1
Although i do believe that Windows operating system may be to fault for some of the problems.	Windows operating system	-1
Great OS, fabulous improvements to the existing line bumping up the processor speed and adding the thunderbolt port.	OS	1
Images are crisp and clean.	Images	1
although its windows vista compared to windows xp sucks.	windows vista	1
We have had numerous problems with Vista, such as Adobe Flash player just quits and has to be uninstalled and then reinsalled, Internet Explore just quits and you lose whatever you were working on, also, the same Windows update has appeared on this computer since we got it and has been updated probably 400 times, the same update.	Vista	-1
One more tip, please purchase this model and get a 4GB stick of RAM to save you $10	4GB stick of RAM	1
It has bein into the shop to get a new hardrive 2 times and to fix the touch control buttons on the keyboard!	hardrive	-1
I always have used a tower home PC and jumped to the laptop and have been very satisfied with its performance.	performance	1
The computer runs very fast with no problems and the iLife software that comes with it (iPhoto, iMovie, iWeb, iTunes, GarageBand) is all very helpful as well.	runs	1
At first it worked well for a month or so then the system board failed and I send it in to toshiba some complaints and three weeks later I then receive my laptop back only to discover that it still has the same problem so now I have to send it back again to get it fixed again.	system board	-1
It has plenty of memory, lots of hard drive, and great graphics.	memory	1
It didn't take me long to get switched over to the Mac computer programs and navigation - it's been just fine and like the way this laptop functions much better.	programs	1
However, my girlfriend realized that the netbook's hinge is a bit loose (when you open or close the LCD).	hinge	0
My problem was with DELL Customer Service.	DELL Customer Service	-1
Newegg's RMA service was great as always, I contacted them late Friday night, and they issued me an RMA number and a PrePaid UPS shipping label the very next morning on Saturday.	RMA service	1
Design: very durable.	Design	1
My ONLY issues are: 1) the screen/video resolution won't increase to a higher resolution then 1024 x 60	screen/video resolution	-1
I run Dreamweaver, Final Cut Pro 7, Photoshop, Safari, Firefox, MSN Messenger and a few other applications constantly at the same time.	Dreamweaver	0
I was told by many  that it was a great computer, but we got one of these, and it worked  great for one year, and as soon as the warrenty was up, then it got  really bad.	warrenty	-1
Ive had to call tech support many times.	tech support	0
The Apple applications (ex.iPhoto) are fun, easy, and really cool to use (unlike the competition)!	Apple applications	1
Not to mention it has shit gigs.	gigs	-1
I paid for extra memory and the 17-inch screen, as well as the top of the line DVD and CD burners.	memory	1
Its pretty fast and does not have hiccups while I am using it for web browsing, uploading photos, watching movies (720p) on occasion and creating presentations.	web browsing	1
Quality Display  I love HP,, it's the only computer/printer we will buy.	Quality Display	1
Despite the inconvenient weight, I opted for the 12 cell battery.	12 cell battery	1
The case is carved out of a single block of aluminum.	case	0
the features are great, the only thing it needs is better speakers.	features	1
It was still working, but there was nothing on the screen.	screen	-1
I bought this laptop and found its TAB is not functioning.	TAB	-1
-Called headquarters again, they report that TFT panel is broken, should be fixed by the end of the week (week 3).	TFT panel	-1
The screen is framed by half- to a full-inch margin that is obviously unnecessary, reduces the screen size and increases the bulk.	screen	-1
Though the picture, video, and music software is nowhere close to professional grade software Im used to (CS5) but does the job for beginner and even intermediate media designers.	picture	1
The much lauded combined touch pad and clicker is a nightmare.	combined touch pad and clicker	-1
The Unibody construction is solid, sleek and beautiful.	Unibody construction	1
This MacBook is an outstanding product with great value.	value	1
I had to re-install Windows within two weeks of the purchase and soon discovered cracks in the screen hinges.	Windows	-1
A SECOND PROBLEM INVOLVES THE BATTERY WHICH IS ADVERTISED AS HAVING A STORAGE LIFE OF 11 HOURS BUT WHEN FULLY CHARGED SHOWS ONLY 7 HOURS OF SERVICE.	BATTERY	-1
and plenty of storage with 250 gb(though I will upgrade this and the ram..)	storage	1
"No temporary replacement, they are out of replacements because ""many computers had problems with the Nvidia chipset""-Inquired status of repair."	Nvidia chipset	-1
I took it to friend who temporarily fixed it and I finally paid about 1500 for the extended warranty.	extended warranty	0
Programs would crash all the time, and it turned out to be a very unstable, unreliable laptop for me.	Programs	-1
I BOUGHT THIS LAP TOP AND THE CHARGE TIME DOSEN'T LAST AS LONG AS THEY SAY IT WILL MORE LIKE 2 HOURS	CHARGE TIME	-1
Also, because of the size and consistancy of the laptop computer, some websites wouldn't even attempt to work on the computer because of browser problems.	size	-1
the key bindings take a little getting used to, but have loved the Macbook Pro.	key bindings	-1
Keyboard is reasonable size.	Keyboard	1
I find myself using the 10-key more than I thought I would.	10-key	1
The screen is bright and clear, the operating system is solid and friendly to a novice.	screen	1
It has a .1 ghz faster processor and a stock 500gb hard drive.	processor	1
The feature are good enough for what I need.	feature	1
Finally, the biggest problem has been tech support.	tech support	-1
""" This isn't a big deal, I haven't noticed the issue with DVDs or other media, only through USB output."	USB output	-1
With Windows laptops a wireless mouse is an absolute must.	wireless mouse	0
(I had been a Windows/Linux user before this) I love the size because the screen is big enough for what I use it for (Internet, artwork), and yet it is small enough to be reasonably portable.	Windows	1
But if you're willing to pay another 200 dollar for a windows disc.	windows disc	0
Very good quality and well made.	quality	1
I bought a Logitech desktop set in anticipation for using with the MBP, but I use the touchpad 90% of the time.	touchpad	1
my niece and nephew have played a few web games and it runs anything that doesn't require a dedicated video card.	video card	0
It had the full sized touch pad with 2 buttons instead of just one.	touch pad	0
Typically, when I purchase a new laptop I always end up using an external mouse for convenience.	external mouse	0
It was super easy to set up and Is really easy to get used to.	set up	1
The only thing that can be updated is the video, other than that you're all set.	video	-1
Its a good laptop for its value.	value	1
Then the hard drive failed;	hard drive	-1
This is a great value for the money.	value	1
It was a great laptop, ran great and was really fast.	ran	1
The battery has never worked well.	battery	-1
I will never buy another computer from Dell ever again do to how awful it worked and how I was treated by the company.	company	-1
The only problem is a lack of screen resolutions!	screen resolutions	-1
Typing on the keyboard becomes uncomfortable after extended use due to the sharp edges that your wrists rest on.	keyboard	-1
It has many great programs, such as ILife, iPhotos and others.	programs	1
The processor went on me, the fan went and the motherboard went.	processor	-1
It is very well built.	built	1
I highly recommend this laptop to anybody that wants great performance from a laptop and would like to relax and not become enraged cursing the gods about to throw your laptop out the door.	performance	1
The screen resolution was exactly what I was looking for.	screen resolution	1
Even though it is running Snow Leopard, 2.4 GHz C2D is a bit of an antiquated CPU and thus the occasional spinning wheel would appear when running Office Mac applications such as Word or Excel.	Snow Leopard	1
There is no number pad to the right of the keyboard which is a bummer.	pad	-1
After 20-30 min the screen of the notebook switched off.	screen	-1
If upgrade is possible to the full Windows 7, then I will truly be a very happy geek.	Windows 7	1
I was originally concerned that I couldn't view work I had done in college on my Mac because of the PC formatting, but I was even more thrilled to learn of programs like iLife and iWork that allow you to convert your PC documents into readable files on Macs.	programs	1
10 hours of battery life is really something else....	battery life	1
Runs fast and the regular layout keyboard is so much better.	Runs	1
All the programs are easy and straight forward on my MacBook Pro, it is clean and organized, which I always strive to be myself.	programs	1
I reinstalled windows through the recovery discs and everything seemed good again.	windows	1
Windows 7 Starter is terrific (no you can't change the background) but I don't need to, I use it just for school work.	Windows 7 Starter	1
Support has been lackluster and now I just want a refund.	Support	-1
First of all, they had no record of me having the 3 year warranty I'd paid almost $400 for, and I had to call in, spend hours on their online chat service, and fax in multiple documents.	3 year warranty	-1
""">  iPhoto is probably the best program I have ever worked with: easy and convenient."	iPhoto	1
I love to write and play with graphics and html programming and my new Toshiba works great on both!	works	1
My laptop now has no battery.	battery	-1
It made the computer much easier to use and navigate.	use	1
:-)If you buy this - don't go into it expecting 7 hrs of battery life, and you'll be perfectly satisfied.	battery life	-1
Needs longer lasting battery, More than 1 to 2 Hrs.	battery	-1
in May I started having problems with the USB ports not working.	USB ports	-1
10 plus hours of battery...	battery	1
The design is awesome, quality is unprecedented.	design	1
The Mac version of Microsoft Office is cheaper than buying the actual and works just as well.	Mac version of Microsoft Office	1
The Mac takes about the same amount of starting-up time as the average PC, but keeps itself cleaned up and ready to use.	starting-up time	1
The Toshiba Net book operates very well.	operates	1
the touch pad is fine - again, it's a real touch pad.	touch pad	1
It is also very lightweight, making transporting this computer very easy.	transporting	1
It's wonderful for computer gaming.	gaming	1
AND the best part is that it even comes with a free printer (when they have a certain promotion/offer going, of course)!	printer	1
it is very easy for anyone to use an apple and specially the mcbook pro notebook.	use	1
The flaws are, this computer is not for computer gamers because of the OS X.	OS X	-1
They really do have the worlds very worst repair service.	repair service	-1
They need to stop outsoucing and send some complaint calls to US based customer service agents for those who live in the United states.	customer service agents	-1
I was also able to install and use my Photoshop and AfterEffects programs easily.	Photoshop	1
I'm already hooked on the sleek look and dependability that this laptop has shown.	look	1
And having to deal with the company has been a even worse nightmare.	company	-1
I will definitely be getting a new laptop if it has any more issues after the warranty expires and researching carefully when I do so I don't run accross a situation like this again!	warranty	0
It has all the features that are necessary for college and if not they are able to be added onto the computer.	features	1
I've owned this labtop for less then two months, already the mouse button has broke.	mouse button	-1
It did fairly well, other than it's poor performance, overheating and occational blue screen.	performance	-1
The touchpad is very intuitive, so much so that I never want to use buttons to click again!	touchpad	1
tons of bloatware and junk programs.	programs	-1
lots of extra space but the keyboard is ridiculously small.	space	1
Good keyboard, long battery life, largest hard drive and windows 7.	keyboard	1
The processor is very quick and effective as I load webpages and applications.	processor	1
My battery went bad about a year and a half after having it and it cost around eighty to a hundred dollars!	battery	-1
It pretty much does everything we could ever need, and looks great to boot.	boot	1
As a lifelong Windows user, I was extremely pleased to make the change to Mac.	Windows	-1
The Macbook is also made better, my computer has never got a virus, and the laptop runs just as fast as the first day I bought it.	runs	1
I picked it out because it was inexpensive ($400) and I thought it would be a good, easy to use first laptop.	use	1
Pay attention to the specs if you want these options.	specs	0
It also does not have bluetooth.	bluetooth	-1
great battery life.	battery life	1
The real stand out on this computer is the feel of the keyboard and it's speed.	keyboard	1
At first, the computer seemed a great deal--seemingly high-end specs for a low, low price.	specs	1
Delivery was early too.	Delivery	1
And that probably explains why I've already had my SATA controller go bad within a year of buying it.	SATA controller	-1
It's also very capable of doing moderate video editing (although you may need the performance boost of the larger MacBook Pros for heavy duty mobile video editing).	video editing	1
My main reason to convert was the imovie program.	imovie program	1
It has a faster processor and more ram.	processor	1
Laptops are usually used on the go, so why not give you a better battery?	battery	-1
I wasn't a big fan of the Netbooks but this one was very well designed.	designed	1
And the warranty on this macbook pro can last up to 5 years or 1000 battery recharge cycles.	warranty	1
I still have that stupid bluetooth mouse to!	bluetooth mouse	-1
Would like more trendy, high tech features.	features	-1
Keyboard is great but primary and secondary control buttons could be more durable.	Keyboard	1
I got it back again and was told the motherboard had been replaced, so I was now on the SECOND motherboard within 3 months.	motherboard	-1
Processor - When compared to my 3 week old Early 2011 edition there I barely experience any difference in performance (2.3 GHz v/s 2.4 GHz).	Processor	0
They say it could be the motherboard again, but Dell	motherboard	-1
2nd Best computer in the world  only one way this computer might become the best is that it needs to upgreade patches  to make less easier for people to hack into	patches	-1
Love the speed, especially!	speed	1
It could be a perfect laptop if it would have faster system memory and its radeon 5850 would have DDR5 instead of DDR3.	system memory	1
Not only are the versions of these programs able to be saved, worked on and opened on both a PC and Mac, the versions of these programs on a Mac are graphically and functionally superior.	programs	1
The speed gives you the power to work on these projects seamlessly, and multiple at a time if you sowish.	speed	1
Awesome laptop and the perfect size to carry around in college.	size	1
A MONTH LATER, we reinstall the OS (Vista).	OS (Vista)	-1
Some problems can be fixed if you purchase new software, but there is no guarentee.	software	-1
The battery life is also relatively good.	battery life	1
I definitely suggest getting an extended warranty, you will probably need it!	extended warranty	1
I have found it very easy to use, very imformative, wonder alerts and tutorials making it very easy for someone like me who is not exactly technologically advanced to learn to use the various features and programs.	use	1
I don't have stupid pop up windows (even when I have pop ups blocked), I don't have to wait 5 minutes for a webpage to download, and best of all I can run all the web programming software I need to use all at once without slowing me down.	pop up windows	1
Memory is upgradable.	Memory	1
Web access through the 3G network is so slow, it's very frustrating and VERY DISAPPOINTING.	Web access	-1
The large screen also helps when you are working in design based programs like Adobe Creative Suite.	screen	1
Moral of the story:-Do not buy anything from companies that do not respect their customers.	companies	-1
This is my first Dell I heard their customer service was lacking and that they were working on improving it!	customer service	-1
As well as having the plug in the computer come loose.	plug	-1
Second HDD cover has walls inside that need to be broken if you what to install one.	HDD cover	0
If you want more information on macs I suggest going to apple.com and heading towards the macbook page for more information on the applications.	applications	0
Great product by Apple with the new great looking design.	design	1
I love the keyboard.	keyboard	1
I will have to purchase Spy ware or Nortell for privacy protection.	Spy ware	0
I was said it's videocard.	videocard	-1
For the price and what I get out of it has exceeded my expectations.	price	1
If your time is worth anything to you, if you are tired of rebooting, reformatting, reinstalling, trying to find drivers, if you want a computer to work for you for a change, make the change to this computer.	drivers	-1
The only thing I wish is the 15 inch MacBook Pro has much better speakers on the side of the keyboard.	speakers	0
Now, as easy as it is to use, and I do think it is a great STARTER laptop.	use	1
Setting would change for some reason, the screen size would change on it's own, like the pixel sizes and whatnot.	Setting	-1
It had some kind of pre installed software update that completely shut the computer down when you clicked it.	pre installed software update	-1
Ever since I bought this laptop, so far I've experience nothing but constant break downs of the laptop and bad customer services I received over the phone with toshiba customer services hotlines.	customer services	-1
Also, the space bar makes a noisy click every time you use it.	space bar	-1
iPhotos is an excellent program for storing and organizing photos.	iPhotos	1
Other than that its a great performing machine and well meets all my needs and more.	performing	1
"Called tech support and got the usual Acer ""We don't support software but for $$$ we can help you"" I explained there was no software involved in booting."	software	-1
The programs are great, like iphoto (love the editing capabilities), imail (which can incorporate with the address book on the ipod and ipad), imovie, etc.	programs	1
The only thing I didn't learn in my research was the software I would need like privacy protection and warranty protection, in case it gets broken, or crashes etc.	software	0
Comfterbale to use light easy to transport.	use	1
The Computer itself is a good product but the repair depot stinks.	repair depot	-1
the only down fall is that it has no cd drive but i found that they are very cheap to by and also very portable making this the best friend to someone who is always looking for more space then they have.	cd drive	-1
So, the hard disk capacity really doesn't matter to me.	hard disk capacity	0
Keys stick periodically and I havent had the laptop for 45 days yet.	Keys	-1
I also like that you can scroll down in a window using two fingers on the trackpad.	trackpad	1
Everything from the design to the OS is simple and to the point.	design	1
I'v spent as much for shipping as I would to buy a new netbook -- of course a different brand.	shipping	-1
I personally like the gaming look but needed a machine that delivered gaming performance while still looking professional in front of my customers.	gaming look	1
When you look at the specs on Apple products in comparison to a Dell or a HP, yes they do seem to offer less for a higher cost.	cost	-1
The only downfall is the volume control.	volume control	-1
Very fast boot up and shut down.	boot up	1
I finally decided on this laptop because it was the right price for what I need it.	price	1
If internet connectivity is important I would recommend going with a dell net book for 50 bucks more, or buy a USB wireless card.	internet connectivity	0
I had read online that some users were having sound problems.	sound	-1
My last computer, a Toshiba, cost only $400, and worked like a charm for many years.	cost	1
It discharges too quickly.	discharges	-1
But to be honest, the compatibility issues and the other little quirks make me think I ll buy a PC next time.	compatibility	-1
Then it ceased charging at all.	charging	-1
I am not much of a computer techie, so I can understand some of the internal problems, though I do have trend micro as an antiviral program.	trend micro	0
The computer continued to give me issues and in Late June it completely died again and I tried to call Acer again to get it fixed and they refused to help me, they said my warrenty was up and hung up on me.	warrenty	-1
I've haven't had any major problems with the laptop except that the plastic piece that covers the usb port wires have all come off.	plastic piece	0
Wonderful sleek case design is only on the outside.	case design	1
It is speedy when connected wirelessly to any network regardless if the connection is weak or not.	connection	0
The pricing is very competitive.	pricing	1
Connecting to my wireless router via built-in wireless took no time at all.	built-in wireless	1
This computer is exceptionally thin for it's screen size and processing power.	screen size	1
I have not had a problem with the applications quitting or freezing.	applications	1
This wiped out several programs that were installed on the computer when it was bought.	programs	-1
It's graphics aren't bad at all, for the lower end of the MacBook Pro spectrum, easily capable of running StarCraft II and other games with comparable graphics.	graphics	1
I have Vista, so I am unable to install and uninstall  some programs.	Vista	-1
The screen is bright and vivid and the keyboard is very easy to use, very important for use quick typers.	screen	1
the mouse jumps around all the time and it clicks stuff i dont want it too.	mouse	-1
For those that care about noise this thing doesn't really make any;	noise	1
I had my IWORKS, Itunes, Email, MS Office, network and printers set up and completely working perfectly within an hour.	IWORKS	1
The macbooks are small enough to be very portable yet hold tons of information and performance.	performance	1
The only downfall is a lot of the software I have won't work with Mac and iWork is not worth the price of it.	software	-1
BUT there's this application called Boot Camp which allows you to add another OS X like Windows.	application	0
The mousepad is a huge pain in the arse!	mousepad	-1
I hope to edit this in the next few hours, I am going to try to install my own copy of Windows 7.	Windows 7	0
) I also purchased  Applecare  for $300, which is a three year extended warranty, since I ve never seen any laptop that lasted more than two.	Applecare	0
Whenever I call Dell about an unrelated problem, they ask me if my laptop is running slowly and if I'd like to purchase more memory for $75.	memory	0
since then i have had minor problems with slow operation.	operation	-1
Registration/1st use is easy.	use	1
Take your time and go through the tutorials patiently.	tutorials	0
This time the mouse pad and right click key wouldn't work!	mouse pad	-1
The first full charge of this battery got me only about 2 full hours.	full charge	-1
I bought a cordless mouse for it, but don't always take it out;	cordless mouse	1
i am a huge computer person i love anykind of computer that works well, but when i got this one i was so happy with the way it works and how it runs its amazing.	runs	1
They only stay charged a little over an hour.	charged	-1
I could not find a phone number anywhere to call an actual live person for tech support and had to result the their online chat.	tech support	0
Keyboard could use some trimming.	Keyboard	-1
Its white color is stylish for college students and easy to take to carry and take to classes.	color	1
Returned laptop for repair a 2nd time and it came back with obvious physical damage (keyboard bulging and speaker grill pressed in), buttons not working and USB ports inoperative.	keyboard	-1
I got assurances from 2 different people that the remaining 10 months of my warranty would transfer to the new computer.	warranty	1
The letter A stopped working after the first week.	letter A	-1
I took off a star because the machine has a lot of junk software on it.	software	-1
With what I do know how to do, the computer works beautiful.	works	1
Tried to make a recovey disk wouldnt get passed the first recovery disk.	recovey disk	-1
Most everything is fine with this machine: speed, capacity, build.	speed	1
For the same price, you get a lot more in the Asus....1920x1080 res.	price	-1
"I made a photo book as a gift, on my computer, pushed ""Buy"" and it drew from my iTunes account and sent the book to my house, the book was of perfect quality-exactly how I had created it and looked better than I had even imagined."	iTunes	0
I use this for my tutoring business, and since I'm always bouncing from student to student, it is ideal for portability and battery life (yes, it gets the 8 hours as advertised!).	portability	1
It is in the best condition and has a really high quality.	quality	1
When it come time for warranty service to Toshiba you don't matter.	warranty service to Toshiba	0
However the frozen screens kept happening.	screens	-1
3) Horrible customer support	customer support	-1
The LED backlit display makes my pictures pop so much more.	LED backlit display	1
Runs smooth and quick.	Runs	1
The downside to this netbook is pretty much the same for any netbook: screen size is not something I'd stare at for the entire 10-11 hours of battery life five days a week.	screen size	0
The graphics are great.	graphics	1
in 5 months the connect quality got worse and worse.	connect quality	-1
The big screen allows you to enjoy watching movies , pictures and etc!	screen	1
the headphone and mic jack are in front of touch-pad making the touch-pad hard to use when using headphones/mic, not to mention the laptop was designed for right handed person.	headphone	0
For the [$] price (special offer) this is a great laptop.	price	1
the manufacturer's warranty only covers replacement/repair of parts.	warranty	-1
What I'd like is for the laptop to run well without having to purchase additional memory.	run	0
It works exactly like it did the day I took it out of the box.	works	1
It is fast booting up , shutting down, and connection with the internet.	booting up	1
The battery life is great.	battery life	1
This is not a serious gaming laptop or a serious media machine;	gaming	-1
They replaced my hard drive as well as my mother board.	hard drive	0
There is nothing to complain about the system.	system	1
and it comes with the new OSX that comes with new features that makes the use more easy.	OSX	1
Now the screen is going darker, darker, darker.	screen	-1
EITHER THE COMPUTER IS TOO SLOW TO DETECT THE KEYS TYPED (THIS IS UNLIKELY AS I AM A SLOW TYPIST) OR THE KEYBOARD SIMPLY DOES NOT DETECT THE KEYS BEING TYPED.	KEYS	-1
Features such as the Dashboard (allows you to view frequently used tools like a calculator, weather forecast, movie times, calendar, computer post its etc.	Features	0
when i called to have another one shipped or to get my money back they said the return policy is 23 twenty three days from the date of purchase.	return policy	-1
I sent it back and found this time that the battery was faulty, so I got a new one and some other fixes they found.	battery	-1
Great pick for portability and affordability.	portability	1
It's fast, it's easy easy easy to set up, easy to hook to my wireless network.	set up	1
"I previously purchased a 13"" macbook (had pro specs and was aluminum style) which had a nvidia 9800 (If I am not mistaken) and it had major heating issues."	specs	1
The people there just changed for me on the spot and I got a new arm piece and they didn't even request for a receipt.	arm piece	1
I take it everywhere with me because it's so easy to carry.	carry	1
The only thing is that the battery won't last more than 1/2 an hour.	battery	-1
The first fell apart right after the 1-year-warranty.	1-year-warranty	0
The keyboard has a wonderful nature feel.	keyboard	1
They went through asking me open up various components, taking battery out, hard disk apart, and after 2 hours on phone could not fix it.	battery	0
The battery doesn't last long but I'm sure an upgrade battery would solve that problem.	battery	-1
I was looking too closely at the other performance specs and while comparing, I took it for granted that these features were standard.	performance specs	0
I have no idea how this could have even gotten past quality control during production.	quality control	-1
I bought this last week, and the very next day had to return it because it over heated and the touch-mouse stopped responding.	touch-mouse	-1
The cover for the DVD drive soon came off, too--a mark of poor construction quality.	cover for the DVD drive	-1
But the arm velcro is torn after one use.	arm velcro	-1
The software is amazing.	software	1
"We carry the netbook around here and there, hence it's kinda of irritating when the LCD just ""slide"" downwards."	LCD	-1
The 2 GB of RAM is plenty, able to run Windows 7 and at least 2 or 3 other programs with next to no slowdown.	2 GB of RAM	1
It is known as Safari, and if you are doing any website work, you should know that many hosting companies do not support it.	Safari	0
Vista is a nightmare.	Vista	-1
The program came with the computer and works beautifully.	program	1
I was loving this Netbook because it had an amazing screen and display and was small and light, but after 1 week it stopped openning web pages for me (even after installing new browsers) then eventually it just started giving me a blue screen and crashing everytime I booted it.	screen	1
The So called laptop Runs to Slow and I hate it!	Runs	-1
Charger seems large for this class of computer.	Charger	-1
I dislike the quality and the placement of the speakers.	speakers	-1
So I called customer support (which is good too) and they went through it and it is just a safety feature and it does not affect performance at all, I just chose to hide the message.	customer support	1
The unibody design is edgy and durable.	unibody design	1
STOPPED BOOTING UP less than a week after my one-year warranty was up.	BOOTING UP	0
But, for the cost this is a winner.	cost	1
Later it held zero charge and its replacement worked for less than three months.	charge	-1
Also, the battery does not last very long at all.	battery	-1
"I bought it from HSN because it was ""bundled"" with extra software, but as it turns out, that software just crashes it more often....."	software	-1
I looked around and based off my price/features comparison from a brand I trusted I landed here.	price	0
I constantly had to send my laptop in for services every 3 months and it always seems to be the same problem that they said they had already fixed.	services	-1
Unless you need the Bluetooth 3.	Bluetooth 3	0
I was sorly disapointed to discover that HP (what I thought was a reputable company) wouldn't honor the warrenty when the fan blade fell apart.	warrenty	-1
More times that not the screen pops up saying I have a bad internet connection, or the page can't be displayed.	internet connection	-1
Do yourself a favor and invest in a few external harddrives if you are planning on purchasing this laptop.	external harddrives	-1
I don't understand why only Windows 7 Starter is included.	Windows 7 Starter	-1
While most people say that PCs hold functionality and value and Macs are just pretty to look at, I think there's something to be said about the simplicity of Macs.	functionality	1
My macbook is so much better looking and so thin!	looking	1
The ease of use is wonderful.	use	1
This system came loaded with Windows 7 Starter.	Windows 7 Starter	0
-When battery life went to 4 hours or less, took it to the MacHouse Amsterdam for repair (26th of August).	battery life	-1
The battery gets so HOT it is scary.	battery	-1
It's so nice to look at and the keys are easy to type with.	look	1
I am forever changed and will no longer buy a Windows based machine for personal use.	Windows	-1
The only thing I would change about it is the mouse keys.	mouse keys	-1
It is absolutely horrible to use, despite all its so called advanced features.	use	-1
Before, I reloaded with Windows 7 Ultimate and used only the downloaded drivers from Acer's site.	Windows 7 Ultimate	0
I have to keep turning it until it decides to lower and there is no mute.	mute	-1
After that I turned to email in my next vain help to get them to acknowledge that the warranty was still valid.	warranty	0
He loves it and it is easy to use and well the schools start teaching the kids early about computers so it was easy for him to get started.	use	1
u can do what u want in just few seconds, even to start up your computer takes few seconds.	start up	1
Also, macbooks come with much more features which are so cool!	features	1
They sent out a Sony 'Certified' technician.	Sony 'Certified' technician	0
They have developed excellent proprietary software for editing video and pictures and I'm looking forward to utilizing these tools on the regular.	proprietary software	1
Getting the Apple Care plan is a must.	Apple Care plan	1
overall i would recomend this to anybody and tell them that if they want to burn their music or play there video games to buy the cd drive.	video games	0
I am constantly trying to uninstall programs, clean cookies, and delete unused files.	programs	0
The dv4 boasted a faster processor, more memory, and a bigger hard drive than my old computer, plus a better quality web cam, nicer screen, and many other features.	processor	1
The only downfall is the battery only last 1.5-2.0 hrs when not plugged in.	battery	-1
The graphics on this computer are also stellar - very clear and vivid.	graphics	1
Aside from the trial software and the short battery life, lack of a webcam, its great.	trial software	-1
As a die-hard Windows enthusiast, I shunned the idea of a Mac until this point.	Windows	1
I think that if it is the motherboard again so soon that they should replace it.	motherboard	-1
The computer loads in about a 1/10th of the time that my PC did, and I have all of the programs that were on my PC.	loads	1
Graphics are clean and sharp, internet interfaces are seamless.	Graphics	1
The newer black keyboard took a little bit away from the previous gray one which looked really slick, but it is still a great notebook!	black keyboard	-1
Sony parts reliability and quality of service is recenlty the worst.	service	-1
As with any laptop not purchased with software options, it comes with a lot of what I consider useless applications.	software options	-1
Its Office compatible, but the features and its functioning is all new again so you might as well save the money and just learn the pre installed mac programs.	Office	1
It just works flawlessly!	works	1
"Do you think I purposely ""destroy"" my netbook, so that I can demand a new set? Do you think it's fun to take public transport all the way to the service center and get a non-satisfactory solution? Or rather NO solution."	service center	-1
I'm having the laptop returned unrepaired since paying $176 every 3  months just isn't worth it (that's about how long the port seems to  last).	port	-1
also the battery is completely shot.	battery	-1
The biggest problem is that the box had no instructions in it.	instructions	-1
But after using it a couple of weeks, the overall operation is poor.	operation	-1
Screen is crystal clear and the system is very responsive.	Screen	1
Or the cursor would show up some place else.	cursor	-1
It is easy to operate and I have already ordered more software and gadgets for my new Rolls Royce of laptops.	operate	1
it might be something deep within Windows, for I was unable to create a disk image on my hard drive.	Windows	-1
The track pad to me is what really stands out though, you can do several different things with it just depending on how many fingers you use on the track pad, awesome thinking Apple!	track pad	1
Now I had not tried to use this since the disc drive had been replaced and after taking it back to the Geek Squad I found out they had accidently not used the right drive when they replaced the first one, so back it went to get the correct drive.	disc drive	-1
First, you ll discover that the word processing program known as  Appleworks  rarely translates perfectly on anyone else s computer, if it translates at all.	word processing program	-1
I already have a HP laptop I bought last year that's standard size.	size	0
Battery is not upgradable to a longer life battery.	Battery	-1
apple has a reputation and is well known for its easy usage.	usage	1
Returned laptop for a 3rd repair and it came back with previous problems fixed (except for speaker grill) but the unit started locking up during use and eventually would not operate at all.	speaker grill	-1
"I just plug this into my 22"" Monitor and the speedy MacOSX performs just as well on this dual-core that my Dell did with Windows 7 with a quad-core."	"22"" Monitor"	1
Love the graphics, awesome programs (including Garageband), and really cool default background.	graphics	1
Screen, keyboard, and mouse: If you cant see yourself spending the extra money to jump up to a Mac the beautiful screen, responsive island backlit keyboard, and fun multi-touch mouse is worth the extra money to me alone.	Screen	1
The OS takes some getting used to especially after being a Windows user for so long but the learning curve is so worth it!	Windows	0
I also purchased iWork to go with it which has programs for word processing, spreadsheets, and presentations (similar to Microsoft Office).	iWork	0
Overall, I experienced a huge change in that my mac runs pretty fast compared to my old PC.	runs	1
When I got the computer back and realizwed it still was not correct HP told me it was out of warranty and now it was my problem.	warranty	0
It also came with a built it web cam which is great because I can see an communicate with my family members back home.	built it web cam	1
Good monitor and performed well.	monitor	1
"I was a little weary at purchasing another 13"" macbook almost 2 years later but t looks like the newer macbooks have gotten its current line of graphics cards in order this time around."	graphics cards	1
They are by far the easiest systems to actually learn about computers with.	systems	1
this apple navigates you thru the unexplored world of the internet.	internet	0
The video card is great for media, and above average for gaming, but not a gamers first choice.	media	1
I had of course bought a 3 year warranty, so I sent it in to be replaced and (almost 2 months later) the dv4 is what the sent me as a replacement.	3 year warranty	0
Apparently there is a manufacturing defect, something with the amount of thermal paste.	thermal paste	-1
Despite the claims of the Apple apologists (a vice of which I am recently myself reformed) the internals of Mac laptops are NO different from PCs' at this point.	internals	-1
Took several hours with customer support before I could even start the PC out of the box.	customer support	-1
Windows Vista makes this computer almost unusable for online service.	Windows Vista	-1
I contacted Acer and they are giving me FREE recovery DVDs, so don't go and pay for them, just ask for them and they should give them to you.	recovery DVDs	1
Now when I order I did not go full scale for the webcam or full keyboard I wanted something for basics of being easy to carry when I use crutchs or wheelchair and with a backpack laptop bag.	webcam	1
Can listen to my music and watch my videos with ease and with a great display.	display	1
Otherwise, all other features are a 1	features	0
The performance is awesome.	performance	1
The display is beyond horrible.	display	-1
There is hardly any memory on the computer's hard drive.	memory	-1
Actually, I had noticed the one on the sales floor also didn't have sound!	sound	-1
Next, most Acer laptop fans are on the bottom which is right on your laptop.	fans	0
the laptop preformed pretty well.	preformed	1
I got my MacBook Pro because I wanted to do all the stuff I need to do without worrying about the system quitting on me or freezing for a few minutes.	system	0
I loved the netbook (minus the fact that it was windows OS) until this started happening.	windows OS	-1
Theres also iDVD, a program dedicated to putting all your favorite media together- photos, recordings, video projects into one program so that you can create the perfect memoir for your parents, family, siblings, and any other person important in your life that there may be.	iDVD	1
If what you need is a machine to do some surfing, email checking, word processing, and watching a movie or two, this is the machine you want.	surfing	0
the mouse pad and buttons are the worst i've ever seen.	mouse pad	-1
Awesome graphics!	graphics	1
It really is perfect for work and play.	work	1
The pro is a great product, I wish that the 13 inch models came with the Intel i processors and had a more comfortable edge (the edges hurt my wrists).	Intel i processors	-1
The battery life sucked the juice from my laptop and when the extended life battery went out we were SOL there to, so much for that warranty covering all the products we purchased.	battery life	-1
I have had another Mac, but it got slow due to an older operating system.	operating system	-1
That's very possible, but since they don't make Windows XP drivers for the sound card in this machine, I was stuck until Windows 7 came out.	Windows XP drivers	1
I'ts nice to have the higher-end laptops, but this fits my budget and the features I need.	budget	1
Was disappointed to find out that the model had been discontinued, apparently because of known motherboard problems.	motherboard	-1
Also the speakers are not very loud, But it is a netbook.	speakers	-1
LOVE THIS LAPTOP WONDERFUL PRICE FOR WHAT YOU GET!	PRICE	1
Just a black screen!	screen	-1
A key contributor that led me to Mac is the art aspect.	art aspect	1
Eventually my battery wouldn't charge, so unless I had it plugged in it wouldn't even power on.	battery	-1
Purchased for development purposes, but it has turned into my everyday laptop as well for surfing, e-mail, etc.	surfing	1
My first problem was with the pre-loaded Norton Firewall/Security program.	pre-loaded Norton Firewall/Security program	-1
I had a USB connect but, i can't use it because it is not compatible.	USB connect	-1
Accordingly, I have decided to NEVER purchase another HP product (my five year old Compaq) lasted 5-years before the hard drive crashed.	hard drive	-1
I know that everyone thinks Macs are overpriced and overrated, but once you get past the initial expense you'll find that they're worth every penny (besides, there's always the financing plan that Best Buy offers).	expense	-1
I love the multi-touch trackpad.	multi-touch trackpad	1
HP is more interested in selling extended warranties (which cost more than the netbook new) then they are in helping or fixing.	extended warranties	-1
"Not too much ""junk"" software to remove."	software	1
System is loosing about 20% of performance because of that.	System	-1
It is easy to use, good quality and good price.	use	1
The difference in the Apple keyboard from a PC's keyboard took a bit of tim to get used to, but overall it's worth it!	Apple keyboard	0
The extended warranty for the $4000 and up computers was the only one available for purchase on the drop drown menu.	extended warranty	0
Only issue is that it is a little slow, and I'm fixing that by adding more RAM.	RAM	0
The hard drive crashed as well, and I had to buy a new  power cord.	hard drive	-1
Another issue I have with it is the battery.	battery	-1
After 2 months of complaints, Asus finally sent the right power supply to my techies.	power supply	0
That included the extra Sony Sonic Stage software, the speakers and the subwoofer I got (that WAS worth the money), the bluetooth mouse for my supposedly bluetooth enabled computer, the extended life battery and the Docking port.	Sony Sonic Stage software	1
My MacBook Pro works like a dream, it has never overheated, or even been slightly warm for that matter.	works	1
PC users use the Powerpoint program for slide-show presentation and Mac users utilize Keynote.	Powerpoint program	0
I get a ton of compliments on its size, and speaking as someone who regularly commutes on a bus, I can attest to the fact that this is the perfect size computer if you're restricted to the width of your body for computing room.	size	1
It takes me approximately 3 tries to get to each site, then after closing the browser and reopening it it actually works.	browser	0
Easy to carry, can be taken anywhere, can be hooked up to printers,headsets.	carry	1
also the keyboard does not liht up so unless your sitting in a room with some light you cant see anything and thats bad for me because my boyfriend tends to watch tv in the dark at night which leaves me with no way of seeing the keyboard.	keyboard	-1
When I got my laptop back after this first instance it worked okay for a little bit then I started expeirencing issues again, everything from programs and drivers failing again, to it powering off for no reason, to locking up and freezing and just all sorts of issues.	programs	-1
Love that it doesn't take up space like a regular computer.	space	1
Asked the customer service rep.	customer service rep	0
So, I took it back to the apple store and they narcissist genius bar staff) fixed it by resetting the fan at boot up.	genius bar staff	0
-4 RAM slots, 2 HDD Bays*, 16GB RAM support -No Wireless Issues, at least for me.	RAM slots	1
I agree with the previous comment that ASUS TECH SUPPORT IS HORRIBLE WHICH IS A CON IN MY OPINION.	ASUS TECH SUPPORT	-1
In fact, somehow (and I never opened it up) some specks of dust or something got inside the screen and are now there permanently, behind the front of the screen, in the way of the display.	screen	-1
the mouse on the pad, the left button always sticks.	mouse on the pad	0
i have tried to charge on different batteries with no luck.	batteries	-1
I would recommend this computer to anyone searching for the perfect laptop, and the battery life is amazing.	battery life	1
True quality at a great price!	quality	1
Not easy to carry.	carry	-1
The programs that come standard with the Leopard running system are enough for the average person to run all the basics.	programs	1
"So what am I supposed to do?  The LG service center cannot provide me the ""service"" when it is called the ""service center""."	LG service center	-1
The Material this Pro is made out of seems a lot nicer than any PC  Specs: Like I said this performs a lot better than any computer I've had in the past.	Material	1
"After doing extensive research, macconnection had the lowest price on the 15"" MBP i5."	price	1
I am ADDICTED to photo booth!	photo booth	1
The operating system and user interface is very intuitive, and the large multi-touch track pad is amazing.	operating system	1
Hard disk - The new editions gives you more hard disk space (500GB instead of 320GB) but time has taught me never to trust an internal hard disk.	Hard disk	1
It is extremely portable and easily connects to WIFI at the library and elsewhere.	connects to WIFI	1
First things first, Macbook pro has many applications to make life easier, unlike the windows computers.	applications	1
And the screen on this thing is absolutely amazing for high quality videos and movies and gaming.	screen	1
I considered I may have too much on the computer, but after looking, there was plenty of space and that is not the issue.	space	1
i must keep it plugged in at all times because it will not keep a charge for longer than four minutes.	charge	-1
Summary: I've had this laptop for 2 months, out of the blue the power adapter stops working.	power adapter	-1
I saw walmart had the same computer for about $650 but still knowing what I know now,I would not buy it at that price.	price	-1
Of course, for a student, weight is always an issue.	weight	0
Now mainboard is broken, have to wait for a new one.	mainboard	-1
The speed difference is next to NOTHING for a mac, and the hard drive can be manually upgraded or you could just buy a $60 500gb external hard drive.	speed	0
2.The wireless card is low quality.	wireless card	-1
They also use two totally different operating systems.	operating systems	0
They are about the same size keys.	keys	0
The people are frustrating to work with, the product itself is very cheaply made, and the accessories are less than satisfactory.	accessories	-1
They offer the best warranty in the business, and don't 3rd party it out like Toshiba.	warranty	1
The only problems are the sound isnt very loud I have to wear headphones.	sound	-1
Again- windows based machines were not giving me anything to work with!	windows	-1
i love the size of the computer since i play games on it.	size	1
You know, using the computer should be fun, not aggrevation, especially when you are playing games or working with photos.	playing games	0
There are no viruses or spyware to worry about like on a Windows computer.	Windows	-1
To be honest i think it was faulty equipment or something but idk.	equipment	-1
I also love the small, convenient size of my laptop, making it a perfect tool for my academic studies.	size	1
I love its solid build, light wt and excellent battery life (for now).	build	1
while about 8 years ago, I hope that the quality has changed.	quality	-1
The difference is it's a whole lot of fun using the laptop now, still learning the Apple navigation, but is fun and comes with a lot of cool apps.	Apple navigation	1
-I propose that I can just swap the hard drives.	hard drives	0
The battery holds up well, it's built very solidly, and runs fast.	battery	1
Sound card is limited though.	Sound card	-1
This is a nicely sized laptop with lots of processing power and long battery life.	sized	1
The keyboard, which generally felt okay even for someone used to a desktop keyboard, now looks terrible.	desktop keyboard	0
The display is awesome.	display	1
The keyboard is like no other laptop keyboard.	keyboard	0
-Computer crashed frequently and battery life decreased very quickly.	battery life	-1
Every driver on the drivers/applications DVD is everything you will need for a reload.	driver	1
I called their repair depot as was told they would send Me a new box to return the computer to the repair depot.	repair depot	0
It's also fairly easy to use the Operating System.	Operating System	1
We figure that after everything HIS pc actually ended up costing $350 more than my original Mac.	costing	-1
Peformance is good for the price.	Peformance	1
Summary: HP knew they were shipping out bad BIOS and did nothing proactive to resolve it.	BIOS	-1
I had 3 months when the ports started going out.	ports	-1
The improvements to the OS have been relatively gradual, but substantive.	OS	1
It is super easy to use.	use	1
Many of my classmates computers hard drives crashed.	hard drives	-1
Ease of use is just one of the benefits I love about my Mac.	use	1
I wouldn't play a first-person shooter with this, mind, but if you wanted to run MS Office, email, chat, download a video, listen to music from a certain fruit-named music store, and were looking for a highly portable yet powerful netbook to do that all in, I'd highly recommend checking this out.	MS Office	0
"The 13"" Macbook Pro just fits in my budget and with free shipping and no tax to CA this is the best price we can get for a great product."	budget	1
The sheer power and flexibility makes the MacBook Pro a must have for any techie!	power	1
The notebook is lacking a HDMI port and a S-video port that would enable one to hook it to a TV.	HDMI port	-1
The speakers on it are useless too.	speakers	-1
Battery is lasting about 6 hours as I am surfing the web on Sundays while checking football scores and watching funny Youtube videos.	Battery	0
Some features arent friendly ( volume wheel, sound quality, etc.	features	-1
"A cheaper price should not equal a ""cheap"" product."	price	1
I think the manual is somewhere on the hard drive, but I rather have a hard copy.	manual	0
Thank you Best Buy for putting my computer together and installing my first software - you guys were GREAT too!	software	0
Adjust the sensitivity since it's not that responsive to begin with.	sensitivity	-1
After a couple of years, my battery life began to diminish but was replaced for free due to a company-wide recall of my particular battery.	battery	-1
The system constantly overheats, the battery life is too short, the case is coming apart, and my core applications that I use every day in my work as a graphic artist run poorly.	system	-1
Later it held zero charge and its replacement worked for less than three months.	charge	-1
The company sent me a whole new cord overnight and apologized.	cord	1
It's even easy to hook up to other wireless networks.	hook up to other wireless networks	1
Also, I have had alot of trouble with the shift key to go to other lines.	shift key	-1
The rep did not even answer my question, I had to ask him, if he understood what I ask or if he spoke english because he didn't even try to acknowledge my question.	rep	-1
It gives me the power and speed that I need to run all the programs I use to edit.	power	1
iLife is easily compatible with Microsoft Office so you can send and receive files from a PC.	iLife	1
As a computer science student in college, I find that the portability, longevity, and ease of use of this computer make me (shockingly) want to do homework more;	portability	1
Again I sent it back and they replaced the motherboard and some fan inside.	motherboard	0
Fully charged, the MacBook Pro can last about five hours unplugged.	charged	1
I know there are way better laptops out there for the same price, and why spend money on shit when you can go out and get yourself a perfectly decent laptop that doesnt suck total monkey balls.	price	0
can't reinstall with standard os cd because of proprietary hardware drivers.	standard os cd	-1
"There is a small red circle next to it with a x in the middle, and when I click on it it says: "" Consider replacing your battery"" and it does not hold full charge."	battery	0
The computer was two weeks late in delivery because HP forgot to complete the required import paperwork.	delivery	-1
The first programm I switched on was a game for my children.	programm	0
I have been very pleased with the performance of this laptop.	performance	1
I bought it for my mom and she reports that the battery life lasts all day for her, it's very lightweight, and the response for the computing she's doing (Internet focused activity: mail, research, etc.) is excellent;	battery life	1
Its very nice and once you learn the features you will be so happy to have such a sophisticated computer.	features	0
It is sleek and lightweight and charges quickly when needed.	charges	1
also you may need to charge it once a day, if for medium use every thing fast and easy with mac  the size and look is the most feature that attracted me to it.	charge	1
( The iBook backup also uses a firewire connection).	iBook backup	0
I did think it had a camera because that was one of my requirements, but forgot to check in the specifications on this one before I purchased.	camera	0
Also the display is exceptional!	display	1
Learning all of the keyboard shortcuts only took a few minutes to get used to as some of the shortcuts are the same on Windows machines.	keyboard shortcuts	1
little short on RAM but you get what you pay for.	RAM	-1
It didn't come with any software installed outside of windows media, but for the price, I was very pleased with the condition and the overall product.	software	1
THEN, one month after the warranty expired, the replacement charger went.	warranty	0
"I love a ""pc"" but I was ready for a change and tired of the windows system."	windows system	-1
Your cursor will end up all over the freaking place,,,it's not uncommon for me to accidentally delete words, sentences, paragraphs because of this mousepad.	cursor	-1
Other installed features, such as certain printer software, are also most attractive.	features	1
Even doing so, the hinge may just be slightly tightened only.	hinge	0
company provides UPS shipping, fast, great!	shipping	1
I would tell the technician I knew exactly what was wrong with it but they did not listen and I had to go through a bunch of junk to get them to tell me I needed to send the computer in.	technician	-1
Great product, very easy to use and great graphics.	use	1
The iLife software that comes with the computer is so simple to use and produces a great finished product.	iLife software	1
The built-in webcam is great for Skype and similar video-chat services.	built-in webcam	1
The shop will definitely push the problem to the service center.	service center	0
PC users work in Word, while Mac users work in Pages.	Word	0
While I mostly use it for email, internet and gaming, I'm confident all other applications live up to the high standard I've come to appreciate from Mac laptops.	internet	1
"This laptop looks great on the surface: 17"" inch screen, good  price-point, nice appearance, boots up quickly, runs fast etc."	"17"" inch screen"	1
The apple systems are over priced luxurys that arn't worth what they are being charged for, this model's specifications are far from being impressive and they only thing you get out of this is the apple name.	specifications	-1
pros:  the macbook pro notebook has a large battery life and you wont have to worry to charge your laptop every five hours or so.	battery life	1
Disappointing for such a lovely screen and at a reasonable price	screen	1
The only bad thing about it is they give you the worst batteries possible.	batteries	-1
Good price.	price	1
THE MOTHERBOARD IS DEAD !	MOTHERBOARD	-1
the speed is fine.	speed	1
Hmmm - that high failure rate sure isn't reflected in the retail price.	retail price	-1
It was not clear that the Microsoft Student Edition that was loaded on the computer, was a six month trial.	Microsoft Student Edition	-1
Good for every day computing and web browsing.	every day computing	1
Also, I have had alot of trouble with the keys sticking and will not type correctly.	keys	-1
Excellent LED monitor and well equipped.	LED monitor	1
This process continued to repeat itself until the mother board had been replaced 4 times and the hard drive replaced 3 times.	mother board	-1
I couldn't believe how long the battery lasted on a single charge.	battery	1
I could save ten essay papers and have hardly any memory left.	memory	-1
Other than that, I would recommend this to someone in need of a cheap laptop with semi-decent gaming capabilities.	gaming	1
But the biggest pain is that tech support is not available 24/7.	tech support	-1
The backlit keys are wonderful when you are working in the dark.	backlit keys	1
I chose the iBookG4, a laptop that is an attractive computer with a large screen big enough to please anyone.	screen	1
The most recent being that my Safari internet browser is freaking out on me, but I have just been using firefox instead.	Safari internet browser	1
I know what 7 hrs of battery looks like.	battery	1
I did not have to call the support line at all.	support line	0
The laptop is outstanding in all aspects except that it has the Windows 7 starter and not the full Windows 7.	Windows 7 starter	1
THE FIRST PROBLEM IS THAT THE KEYBOARD FUNCTION IS SIMPLY UNSATISFACTORY.	KEYBOARD FUNCTION	-1
The DVD drive randomly pops open when it is in my backpack as well, which is annoying.	DVD drive	-1
Garageband is more for the musicians, and the laptop is equipped with a good working microphone, good enough for beginners and musicians at the intermediate level.	Garageband	1
I dual boot with Linux and that other security-prone OS and it performs flawlessly.	Linux	1
The difference is the Toshiba had a lot more memory and hard drive space.	memory	1
There was a little difficulty doing the migration as the firewire cable system can't be used with the iBook.	firewire cable system	0
OS X is solid with lots of innovations such as quicklook which save heaps of time.	OS X	1
But other than that I am blown away by all the features this laptop offers.	features	1
The keyboard is slick and quiet and not bulky like some other laptops I have had in the past.	keyboard	1
Overall, this laptop is definitely a keeper with its simple yet stylish design and its array of fantastic colors to choose from.	design	1
The PhotoBooth is a great program, it takes very good pictures with the built-in camera.	PhotoBooth	1
Many kinds of software that is necessary to the working person is not available and cannot be downloaded.	software	-1
I had to pay for the shipping!	shipping	-1
It bluescreened on me without any warning, running simply basic Chrome.	Chrome	-1
I took 3-4 years researching brands and prices of laptops.	prices	0
But guess what?  (you have to buy an external dvd drive it doesn't have a built in type) The notebook can't be used because it doesn't read anything for an external drive.	external dvd drive	-1
GET THIS COMPUTER FOR PORTABILITY AND FAST PROCESSING!!!	PORTABILITY	1
I use a cooling pad but it doesn't help.	cooling pad	-1
Supplied software: The software that comes with this machine is greatly welcomed compared to what Windows comes with.	Supplied software	1
I'm tired of the inept service.	service	-1
Garageband is easy to work with, like all the other apple applications I've had experience with.	Garageband	1
"No, tey don't even support their own bios and it ""could be a problem with the bios"" How can a company that makes a fairly decent product get away with such insanity??!!"	bios	-1
Because we did not purchase the extended warranty in time, we are on the hook for the repair.	extended warranty	-1
"It started out by randomly ceasing to charge when it was plugged in (mousing over the battery icon would read, for example, ""74%, plugged in, not charging""), requiring me to unplug it and plug it back in several times to get it to charge."	charge	-1
This laptop looked brand new and was shipped very quickly.	shipped	1
Info: Windows failed to load because the kernal is missing, or corrupt.	Windows	-1
The display on this computer is the best I've seen in a very long time, the battery life is very long and very convienent.	display	1
But the quality, in general was less than the worth of the cheap laptop.	quality	-1
In the first moth of owning this computer its hardrive failed which had to be replaced.	hardrive	-1
Its also FUN to use!	use	1
The graphics and screen are stunning and although I was a PC person, I was able to understand how to use a mac fairly quickly.	graphics	1
WIth the upgraded memory, the MacBook Pro never has an issue running many many applications at once!	upgraded memory	1
Simple to use, and great graphics.	use	1
The internet speed is spectacular.	internet speed	1
They claim call center is still down.	call center	-1
Mac also has many apps and programs that are quite cheap or free.	apps	1
My husband uses it mostly for games, email and music.	games	0
I just took the broken cords into the Apple store and they gave me new ones.	cords	1
Apparently under the screen there are 2 little screws and when the screen gets moved back and forth, they come loose.	screen	0
Being a PC user my whole life, it's taking a bit of time to adapt to the OS of a Mac but I'm finding my way around.	OS	0
The computer will constantly be getting hot and burning your leg unless you go through the hassle of taking off the entire back of it just to clean out the fan.	fan	-1
"I have in the past gotten superfine sandpaper and ""fixed"" the edges by rounding them off."	edges	-1
Downfalls: sharp edges.	edges	-1
i needed one to be able to carry to work everyday and this one seems to fit all of the criteria.	carry	0
The screen is gorgeous - yummy good.	screen	1
Did I mention everything about it, from size to weight to keyboard screams BULK?	size	-1
I had it four months when my disc drive refused to open.	disc drive	-1
So, after Apple replaced the hard drive I enjoyed another 4 months of my new computer, until it froze this morning--completely.	hard drive	0
Once again, I was told it was the suspicious  power supply  problem.	power supply	-1
"The Macbook starts fast, doesn't crash, has a fantastic display, is small and light (I have the 13.3"" model), and isn't always complaining about updates, lost connections, errors, blue screens, etc."	starts	1
Unable to boot up this brand new laptop.	boot up	-1
In addition, all the design tools on Pages and Keynotes makes it much easier to create professional looking documents and presentations.	Pages	1
The port is secured to motherboard so when this  happens you can't see the plug at all, it's just gone.	port	0
I love the feel of the key board, as well as the trackpad.	key board	1
Now I have the best of both worlds with all of the power and ease of the Mac!	power	1
Ease of use is just one of the benefits I love about my Mac.	use	1
Now the machine won't connect and Toshiba says that they did replace the connection card in May but they only warranty the repair for 30 days and now I'm out of warranty even though this has been a constant 5 month occurance since I bought the netbook.	connection card	0
But, buy this model and just purchase 4GB of RAM (2x2GB for $92 or 1x4GB for $99), and save yourself $100 than the other model with 8GB of RAM.	4GB of RAM	0
If you're looking for something to fly through those massive spreadsheets or play a graphics-intensive game, you'd be better off getting a machine aimed at that segment of the market.	game	0
Browsing, also, was no problem for me when I used itunes ( which usually slows down my PC ).	Browsing	1
Again, decent comp for the price, and I was in need of one quickly as my other laptop died on me.	price	1
so in a brief summary i would have to say that i would not recommend dell vostro 1000 to anyone due to it being a down right awful setup so in my opinion you should steer clear of them if you want a decent laptop.	setup	-1
My friend just had to replace his entire motherboard, so did my wife, and it looks like I will have to as well.	motherboard	-1
Toshiba customer services will indirectly deal with your problems by constantly tranferring you from one country to another, and I am not kidding you, I called different hours of the day and you'll get someone else from another country trying to get you to tell them your life story all over again, since they make it sound like they don't have your history list of your calls right in front of them.	Toshiba customer services	-1
Quality Display  I was surprised with the performance and quality of this HP Laptop.	Quality Display	1
The battery life also doesn't keep up with the claim but still I think macbook is much ahead from the rest of the pack.	battery life	-1
The internet capabilities are also very strong and picks up signals very easily.	internet capabilities	1
Its fast, has High definition quality in the videos.	High definition quality	1
Another Great thing is the Beast graphics.	Beast graphics	1
Everything I have tried has worked and I never have to carry the wall charger cause the battery is so awesome.	wall charger	1
The battery life is probably an hour at best.	battery life	-1
This is a review of windows vista system.	windows vista system	0
cosmetically, the only thing they changed was 2 of the Function keys at the top.	Function keys	0
But sadly the replacement froze-up while updating the BIOS again and shut down and would not turn back on.	BIOS	-1
There's literally no way to make it sing with Vista.	Vista	-1
Screen size is perfect for portable use in any environment.	Screen size	1
First, it does not have a push button to open the lid.	push button	0
I used to build my own desktops from the component parts, and recently my 7 year old Pentium 4 with HT 1 GB ram SATA desktop stopped working (this was a rock star 7 years ago).	Pentium 4	0
I now realize that my $900 would have been better spent on a Windows laptop.	Windows	1
) And printing from either word processor is an adventure.	word processor	-1
After purchasing this thing, I find out that I need a special interface device to connect my camera, and that it cannot be purchased at the store - only on line.	interface device	-1
Another included program that is laughable is the chess game.	included program	-1
Yes, I thought the expese was a little much, but I now realize you get what you pay for.	expese	-1
It works great for general internet use, Microsoft Office apps, home bookkeeping, etc.	internet use	1
The price was very good, and the product is top quality.	price	1
It played various games without problems and ran aero smoothly and flawlessly.	games	0
After replacing the hard drive the battery stopped working  (3 months of use) which was frustrating.	hard drive	0
The screen almost looked like a barcode when it froze.	screen	-1
Its small enough where I can take it pretty much anywhere, but still has a big enough screen to get everything done.	screen	1
It even has a great webcam, and Skype works very well.	webcam	1
I love the solid machined aluminum frame, and the keyboard is the best of any laptop I've used.	machined aluminum frame	1
You can even run a parallels type program easily and run any leftover PC software that you absolutely cannot be without.	parallels type program	1
This computer I used daily nice compact design.	design	1
The ATI graphics card is a huge plus, definitely a good value if you need to be able to run some slightly older games that a Intel built-in card would have trouble with, such as Half-Life 2 or even World of Warcraft.	ATI graphics card	1
It was hard to handle and operate at school.	handle	-1
It has easy to use features and all the speed and power I could ask for.	features	1
My power supply cord developed exposed wires within the first year of ownership, so it was covered by the Applecare warranty plan.	power supply cord	1
I preferred the fit and feel of the 13 inch.	13 inch	1
power supply went bad after 2 weeks --	power supply	-1
The screen takes some getting use to, because it is smaller than the laptop.	screen	-1
I regret buying it before understanding how awful it is to use.	use	-1
The right speaker did not work.	right speaker	-1
Dealing with the support drone on the other end of the chat was sheer torture.	support	-1
The Final Cut Pro on this laptop is so fast and easy, and I can use this to seemlessly transfer all my work to my home computer, which is also a mac.	Final Cut Pro	1
The computer runs extremely slowly, whether opening Word or My Computer.	runs	-1
The Mac Snow Leopard O/S is extremely easy to use, although very different than Win XP, Visa or Win7.	Mac Snow Leopard O/S	1
Startup in about 30 seconds, shutdown in 2-4 seconds, resume from sleep in 0-2 seconds.	Startup	0
The screen is nice and the images comes very clear, the keyboard and the fit just feels right.	screen	1
I have only had PCs with Windows before so this takes a little getting use to.	Windows	0
super fast processor and really nice graphics card..	processor	1
But sitting on a lap or on a desk in front of you it looks more than big enough (this could be because Im used to my Lenovo 10 tablet now) plus this is a great size if I want to unplug the external keyboard, mouse, and monitor to take it with me when I take photos and video.	size	1
The only objection I have is that after you buy it the windows 7 system is a starter and charges for the upgrade.	windows 7 system	-1
I dislike the weight and size, cubersome.	weight	-1
The wheel that turns the volume up and down doesn't work in real time.	wheel	-1
I cannot be happier with the service or product.	service	1
I do transcription work on the side, and the flatline keyboard makes typing quick and easy as well.	flatline keyboard	1
Speakers doesn't sound that great.	Speakers	-1
I love windows 7 but i can't give Toshiba any credit for that, unless y'all get serious about ergonomics and making required connections less obtrusive i will be looking to different manufacturer next time.	windows 7	1
After numerous calls to Applecare tech support, I was directed to send in my computer;	Applecare tech support	-1
"The ""abuse"" is that I pushed the power plug in too hard."	power plug	-1
The resolution on the screen is almost pure HD.	resolution on the screen	1
Not sure how I recommend it for quality gaming, as I have a desktop rig for that reason.	gaming	-1
Great value, fast delivery- Computer works as if brand new, no problems, very pleased	value	1
The Internet Explorer was very slow from the very beginning.	Internet Explorer	-1
The AC power port becomes loose over time	AC power port	-1
"As a user of a PC, I will will admit that the macBook Pro has a better running system in which I found myself ""Getting the job done quicker."	running system	1
and they replaced the awesome ergonomic small lightweight power supply with a power supply that weighed more than the machine itself.	power supply	1
Enjoy that Toshib force and durability unparalleled	force	1
Which is great I am running Vista Business and scored a 5.X on the index I have never seen a windows machine have a total score in the 5's.	Vista Business	1
I use the computer to basically check emails, surf the web, print coupons and for my college papers.	surf the web	0
We love the size of the screen, although it is still lightweight and very easy to tote around.	size of the screen	1
so the fact that the computer does not work on the 24 twenty fourth day is my fault.	work	-1
I would definitely reccomend this if you are in the market for an easy to use, stylish, fun, awesome computer.	use	1
the battery is irreplaceable.	battery	-1
I have never really been big on downloading anything so I wasn't too worried about getting a virus, plus I thought I was protected by Norton.	Norton	-1
The internet was locekd and froze every time it was trying to be used, and the command prompt would not work at all.	internet	-1
It's software and speed enable it to do amazing things.	software	1
Could not keep up with me and finally the hard drive went out.	hard drive	-1
I am most impressed with the programming, including the iPhoto.	programming	1
I upgraded it's RAM to 2GB, I am very happy with it.	RAM	1
I purchased a Toshiba Satellite M60 (with harman/kardon speakers!) in December of 2005.	speakers	1
They should have included more memory on their computers if they knew Vista would run slowly.	memory	-1
Battery life could be better but overall for the price and Toshiba's reputation for laptops it's great!	Battery life	1
After the warrenty expired the hard drive went bad and it would have cost more to fix then to replace.	warrenty	0
The Windows 7 Starter is, in my opinion, a great way to think about using your netbook: basics, basics, basics.	Windows 7 Starter	1
I purchased this netbook after my original Toshiba laptop crashed right after the warranty expired.	warranty	-1
Apparently well-built and gorgeous to look at, the i5 MacBook Pro is a winning combination of price and performance.	look	1
The apple care has never failed me, and I expect it to be the same for this computer as well.	apple care	1
So I called Compaq, and after being on the phone for 3 hours, i finally got a replacement which I shouldn't have had a problem getting since it was under warranty.	warranty	0
So we exchanged it for the same on and after 2 hours it didn't work.	work	-1
I love the size, keyboard, the functions.	size	1
the mouse is way way way to sensitve.	mouse	-1
The OS is still as fast as the day that the laptop was purchased and continues to run flawlessly.	OS	1
Also, I issued a replacement RMA for a few dead pixels in the upper zone of the screen, which is noticable to me.	screen	-1
After way too many times sending the thing in for repairs (delivery service was slow, and without the laptop I had no access to the internet, and thus no way of tracking it to find out when I might hope to see my computer again), it finally kicked the bucket after just over 2 years.	delivery service	-1
My friend reports the notebook is astonishing in performance, picture quality, and ease of use.	performance	1
the i3 processor doesn't seem to run hot and the fan rarely turns on.	i3 processor	1
Another THREE weeks later I had my laptop back with a new mousepad, keys, and casing.	mousepad	0
The only thing I don't understand is that the resolution of the screen isn't high enough for some pages, such as Yahoo!Mail.	resolution of the screen	-1
"The only thing I wish this had was the option to turn off the touchpad with a button like my big 16"" laptop does."	touchpad	-1
very convenient when you travel and the battery life is excellent...	battery life	1
The machine is slow to boot up and occasionally crashes completely.	boot up	-1
This is great if you have several lectures back to back and don't have a chance to charge during one of the lectures.	charge	1
I wish Toshiba would allow their customers to select an option that only boots the OS at setup and removes all the unnecessary stuff.	OS	0
the screen brightness automatically adjusts.	screen brightness	0
My laptop cost approximately $2,300 and DIED after only 2-years, 10-months and 18-days of use.	cost	-1
The sound is a bit quiet if you're on a plane, this can easily be overcome with a decent pair of head phones.	sound	-1
(The SATA controller is the motherboard chip that lets the CPU talk to the hard drive.)	SATA controller	0
The buttons you have to press a little harder than most.	buttons	-1
The battery life was supposed to be 6 hours, but even if I ran off the battery with the high effeciency setting the battery would only last me on average about 2.5 to 3 hours.	battery life	0
Right size and weight for portability.	size	1
The battery life also doesn't keep up with the claim but still I think macbook is much ahead from the rest of the pack.	battery life	-1
It was loaded with Windows Vista Home Premium--delivered with only 1GB of RAM, and it was a *dog*.	Windows Vista Home Premium	0
The reflectiveness of the display is only a minor inconvenience if you work in a controlled-lighting environment like me (I prefer it dark) or if you can crank up the brightness.	display	0
My one complaint with this laptop is that I've noticed an electronic fuzz sound coming out of the headphone jack when headphones are plugged in.	electronic fuzz sound	-1
While it was highly rated, would I like it? I tried the keyboard at the store, and it seemed ok.	keyboard	0
Treat yourself to a more expensive, long-lasting laptop of quality like a Sony, Apple, or Toshiba.	quality	1
I have had to call with a few questions or issues and they have helped me for free, even without the warranty.	warranty	0
Was searching online for a power supply when I found this site.	power supply	0
But to be honest, I don't use my computer for anything like graphics editing and complex data analysis and gaming.	graphics editing	0
I would  rather spend my money on a computer that costs more then a Toshiba that  isn't good at all.	costs	-1
(No problem with the ordering or shipping by the way.	shipping	1
And the ram (the thing that makes it faster) comes sporting 2 gigs for high performance to handle more stuff at once and surf the web a whole lot faster than before.	ram	1
The one thing I wish it had was a detailed hardcopy manuel.	hardcopy manuel	-1
I edit and burn to DVD a lot of video, so I obviously could not live with a non-functioning drive.	drive	-1
Fast, great visual!	visual	1
It's priced very reasonable and works very well right out of the box.	priced	1
You will need them if you want to reload the OS (I recommend doing if you can to start fresh and optimal).	OS	0
while the keyboard itself is alright, the plate around it is cheap plastic and makes a hollow sound when using the mouse command buttons.	keyboard	1
There are so many wonderful features and benefits to the new MacBook!	features	1
the mcbook pro notebook will make it easy for you to write and read your emails at blazing speeds.	speeds	1
The only thing i can say is that the touch pad doesnt work like it should all the time.	touch pad	-1
However, I love this particular Mac because its very fast, great size, and has fantastic features like the lighted keyboard and easy mouse pad.	size	1
Battery life needs more life.	Battery life	-1
For some odd reasons the computer doesn't reconize the operation system.	operation system	-1
The trackpad was easy to learn and navigate.	trackpad	1
Applications open in seconds and there are no lags, hiccups or awkward moments when you wonder whether your computer is out for tea.	Applications	1
I respond that I do not have the old computer and this way I would lose the data on my hard drive.	hard drive	-1
Again in February my computer completely failed to the point that it could not load Windows so I contacted Acer to get it fixed thru my Warrenty and it took about 3 days fighting on the phone with agents and it seemed as though NONE of them spoke English.	Windows	0
We paid for the three year warranty and the extended warranty after that one ended as well.	three year warranty	0
Its not just slow on the internet, its slow in general.	internet	-1
It has just enough RAM to run smoothly and enough memory to satisfy my needs.	RAM	1
I acually believe the issue is with the Nvidia grafics card, but still requires a return.	Nvidia grafics card	-1
My husband got me this for Chrismas after getting me a very expensve laptop that did not work after 2 days.	work	-1
The resolution is even higher then any other laptop on the market.	resolution	1
"Then just the other day, my left ""mouse"" button snapped!"	"left ""mouse"" button"	-1
"Laptop is advertised as a 15"" but the casing looks like that of a 17""."	"15"""	0
In due course, I'll remove the hard disc from this new MacBook Pro and dump it where it belongs - in the trash.	hard disc	-1
They break down just as often as PCs do, and the only reason they don't get viruses, is because no one makes viruses for them, they're not better in any way, they are worse, try finding virus protection programs for a Mac, they don't exist.	virus protection programs for a Mac	-1
But with A WAY Bigger Screen, and IS able to connect to an HDMI.	Screen	1
the graphics are awful and the wireless switch it at the top rather than the side which I am used to it being on the side.	graphics	-1
The overall build quality of the unit is excellent and she'd recommend it to anyone else looking for a netbook.	build quality	1
I guess he was the technical person.	technical person	0
A seventy dollar mouse!	mouse	0
The repairs were made quickly though I must say, however the second time they shipped it to the incorrect address and it took nearly a week for them to get it to me.	shipped	-1
when i first got it i thought the size of it was a joke.	size	-1
It is fast and i have not had a problem with internet connection or any other problems.	internet connection	1
I'm really impressed with the quality and performance for the price of the computer.	quality	1
But when I received my replacement, I made BOTH recovery DVDs (4), and a driver/application DVD.	recovery DVDs	0
In addition, there is photo detection software that will allow you to group all the photos together based upon the people in the picture.	photo detection software	1
The speakers are terrible and are probably the cheapest ones I have ever seen in a laptop so if your planning to listen to music I suggest you get something better.	speakers	-1
So then you may be lucky to get ahold to someone who understands that its no good and they will let you send it back, but of course you are taking a chance of them testing it out to see what has happened, and they tell you that it was not on their side , then you are stuck paying for the repair (the price of a new one).	price	-1
It is so simple to use, I use it more than my desktop.	use	1
I also had a problem with the touchpad that caused the mouse pointer to jump all over the screen.	touchpad	0
EITHER WAY, THE KEYBOARD IS UNSATISFACTORY.	KEYBOARD	-1
Well, I have to say since I bought my Mac, I won't ever go back to any Windows.	Windows	-1
I took it in to the Apple store and guess what? They fixed it, no cost out of pocket.	cost	-1
The applications are also very easy to find and maneuver, much easier than any other computer I have ever owned.	applications	1
The large screen gives you the option to comfortably watch movies or TV shows on your computer instead of buying an additional TV for your dorm room.	screen	1
Great laptop for school, easy to use for beginners in the household.	use	1
4) Laptop still did not work, blue screen within a week...	work	-1
The only thing that isn't perfect about this netbook is the speakers, they are not loud at all but I expected that.	speakers	-1
Of course, I inspected the other netbooks and clearly their hinges are tighter and I even demonstrate the difference between my netbook and others.	hinges	-1
Not to mention the fact that your mac comes fully loaded with all necessary basic programs.	programs	1
Didn't work when shipped from Walmart.com but went into a store and exchanged for a working laptop (same make/model).	work	-1
All of the programs (Keynote, Pages, Numbers) have an option to save your documents as Microsoft compatible, which really eliminates the need for the actual.	programs Keynote	1
"The best thing to do is build your own computer, but if u can't company's like dell who allow you to choose the components are better and for the same price you can get a computer who compares to one of apple $2000 systems and if you google ""dell coupons"" you can find codes that take a signifant  amount off the price."	components	1
There is no cd drive on the computer, which defeats the purpose of keeping files on a cd.	cd drive	-1
For me I was lucky and a local store was selling them for $2000 off and Best Buy matched their price so I was able to buy one for under $1000	price	1
Unfortunately, Apple's quality has continued to slide.	quality	-1
I believe that the quality of a mac is worth the price.	quality	1
sometimes you will be moving your finger and the pointer will not even move.	pointer	-1
"The 13"" Macbook Pro just fits in my budget and with free shipping and no tax to CA this is the best price we can get for a great product."	budget	1
I would rate this computer at 5 stars, but considering it has a short life span I can only give it 1 and implore anyone looking at laptops to stay away from this machine.	life span	-1
I also love the design, the looks, the feel, and the my toshiba feature is wonderfull.	design	1
The layout of the MacBook is horrible and confusing;	layout	-1
Was not happy with one of the programs on it.	one of the programs	-1
Also it is very good for college students who just need a reliable, easy to use computer.	use	1
The first one sent: Touchpad didn't work The second sent: USB didn't work The third sent: Touchpad didn't work The fourth sent: Hasn't arrived yet.	Touchpad	-1
Only other thing is that if you are using this for document creation Apple doesnt provide any kind of word processor (such as works for windows), but iwork is cheap compared to office.	document creation	1
It is light and the battery last a very long time.	battery	1
And at one point, they blame me for installing a bad memory stick when I upgrade my memory for the first time during my purchase of the laptop (I bought the memory stick they recomended).	memory	0
The touchpad is extremely sensitive, which is the only drawback.	touchpad	-1
also it comes with very useful applications like iphoto that it is the best photo application i have ever had	applications	1
The acer one computer that I bought is 17 ince screen and its hard to find lap top bags for it, but I like the big screen on it.	17 ince screen	1
Summary: They played games with me for the warranty period.	warranty period	-1
I can have both OSX and Windows XP running at the same time!	OSX	1
Overall : Poor, Features: Average, Performance: Poor, Battery Life: Excellent, Price-Value: Poor	Features	1
Microsoft seems to be unable to keep up with repairs for the multitude of windows problems.	windows	-1
The graphics are stunning.	graphics	1
(I found a 2GB stick for a bit under $50) Nice and portable and definitely a decent enough system to keep you entertained while sitting in the airplane for a couple of hours, or at the hotel taking care of some last minute details and documents.	system	1
after much effort and 10 days ASUS replaced itThe WiFi is very weak.	WiFi	-1
You can call HP and they want you to buy more software to fix it.	software	0
It is easy to navigate and update programs.	navigate	1
All in all, a very disappointing experience except that I learned how good the Geek Squad is and also Customer Service.	Customer Service	1
The only drawback for me is how dirty the screen gets, and rather quickly too.	screen	-1
The laptop is very lightweight, can easily carry around in a knapsack full of text books and it barely adds any weight.	carry	1
Seems to slow down occassionally but can run many applications (ie Internet tabs, programs, etc) simultaneously.	applications	1
I also did not like the loud noises it made or how the bottom of the computer would get really hot.	noises	-1
I had in the past a Dell laptop and they sent me the items it needed or they sent a repair technician to my house to fix it.	repair technician	1
defective software.	software	-1
This computer was so challenging to carry and handle.	carry	-1
Cords coming out the right for power plus cords coming out front for headphones/mic plus network connection on left make for a very messy setup with cords going every direction.	Cords	-1
Unless you want to be inconvenienced with a non working power supply which you can't find a replacement for because they made the attachment so small.	power supply	-1
It is much faster than my desktop which is a Core2 Quad running at 2.83 GHz.	Core2 Quad	0
It is good to know that I can mobilize without having to worry about the battery life.	battery life	1
The screen is nice, side view angles are pretty good.	screen	1
The fact that the screen reacts to the lighting around you is an added luxury-when you are working around others in dark areas and want privacy or don't want to bother them with bright lighting, it is very convenient to have a darker, softer lit screen.	screen	1
3 weeks went by and the computer keeps crashing and will not open any applications.	applications	0
Not to mention sometimes the whole charger unit will decide not to work entirely.	charger unit	-1
Looks nice, but has a horribly cheap feel.	Looks	1
"I have other computers that get strong signals that don't drop in places that this ""net""book loses its signal."	signals	1
The feel of this is better than the Toshiba, too.	feel	1
I would recommend this laptop to anyone looking to get a new laptop who is willing to spend a little more money to get great quality!	quality	1
I upgraded the memory and replaced the base Windows 7 Starter to Win 7 Home, and it runs just fine.	memory	1
I am not sure if it was the drive itself, however;	drive	0
Also, one of the users mentioned how the edges on the macbook is sharp, if you have money to spend on one of the incase shells, it doesn't seem to be a problem.	edges	1
It is easy to use, its keyboard easily accommodates large hands, and its weight is fantasic.	use	1
Called Acer many times, they want me to pay the shipping to ship it to their repair center - I was very disappointed since it is a brand new computer!	shipping	0
I should have checked this before I installed my applications.	applications	0
The battery is really long.	battery	1
Anyway, in early July of this year, the DVD burner stopped working, and the computer stared having issues with power supply.	DVD burner	-1
Had some trouble finding a case that it would fit in.	case	-1
This computer that I have has had issues with the keyboard where it lost half the keyboard functions.	keyboard	-1
Comes with iMovie;	iMovie	1
COMPUTER HAS BEEN AT SERVICE FACILITY MORE THAN IN MY HANDS.	SERVICE FACILITY	-1
When I called Sony the Customer Service was Great.	Customer Service	1
even though I had the receipt in front of me proving it still had 2 months left on the warranty.	warranty	-1
It is a much more streamlined system for adding programs, using the internet, and doing other things everyone does on a computer.	system	1
My computer froze on several occasion, had buttons that randomely would fall off and even had moments when the computer would refuse to turn on at all.	buttons	-1
Not even safe mode boots.	safe mode	-1
This is an over-sized, 18-inch laptop.	18-inch	-1
I had to pay $100 for a universal charger for this cheap $300 laptop.	universal charger	-1
The powerpoint opened seamlessly in the apple and the mac hooked up to the projector so easily it was almost scary.	powerpoint	1
1.You can not change your desktop background (window's 7 starter does NOT support that function).	desktop background window's 7 starter	-1
Took me 11 hours, 3 trips to different FedEx offices, and brutal conversations with 14 of the worse IT support technicians in the world.	IT support technicians	-1
Then after 4 or so months the charger stopped working so I was forced to go out and buy new hardware just to keep this computer running.	charger	-1
As usual at customer service center, she asked me to hold for a moment while she went to the back-office and compare it with other same model netbooks and discussed it with her colleague (I could see them).	customer service center	-1
The screen gets smeary and dusty very quickly and it's very noticeable.	screen	-1
Strengths:Well-shaped Weaknesses:A bad videocard!	videocard	-1
You can't even get a satellite card which is why I bought to begin with.	satellite card	-1
The battery life, before the battery completely died of course, left much to be desired.	battery life	-1
It is a REAL touchpad, not the toy I saw in other brands.	touchpad	1
Long story, but after many calls to various  offices, I was told that no one can override the depot and that managers  don't take phone calls or e/mails.	depot	0
Price and purpose is awesome!	Price	1
Wonderful zooming.	zooming	1
The screen is huge and coloful, but no LED backlighting.	screen	1
In all honesty, if someone is looking for a quality laptop and willing to pay a little more money for a normal sized laptop than a cheaper and less impressive laptop, then do not buy this computer.	sized	0
Everything about this computer is easy to use.	use	1
Worse, for the price I could get a *netbook* that outperforms this machine.	price	-1
It had most of the features and all of the power that I wanted to replace my desktop machine.	features	1
Keyboard was also very nice and had a solid feel.	Keyboard	1
It did not have all the features I expected it to have.	features	-1
No luck, although I waited for hours on the phone-Visited MacHouse, they stated the their call center is down due to too many phonecalls (difficult to believe).	call center	-1
There is a backlit keyboard which is perfect for typing in the dark.	backlit keyboard	1
It has a lot of memory and a great battery life.	memory	1
I spoke with a service rep at Micro Center and his girlfriend is having the same problem with her power adapter, so it's not just an isolated incident!!!	service rep	0
I love this program, it is superior to windows movie maker.	program	1
He has replaced his hard drive twice and (of course) has had to pay for antivirus software every year.	hard drive	-1
This purchase opened me to the world of Macbooks, and I am impressed with the intuition of the design, the beauty of the product, and the excellent technological advances associated with it.	design	1
I've also had to have the keyboard replaced at my expense.	keyboard	-1
"I had the staff telling me older version did not make the fan noise cause it is a ""different"" computer."	staff	-1
Was very much worth the price i paid.	price	1
Even out of warranty!	warranty	0
This is a great little computer for the price.	price	1
Crisp screen, great battery life, and plenty of storage.	screen	1
All apple associates are always wiling to help you out with anything, no matter when you purchased the computer and how many years passed.	apple associates	1
Also, my sister got the exact same laptop (since they were so cheap) and after 8 months, the screen split in half just from everyday use.	screen	-1
The Toshiba Satellite has been more than I expected for the price.	price	1
I had to adjust my mousepad sensitivity, because it is very sensitive.	mousepad sensitivity	-1
I wish iWork or MS Office came with the Mac, but MS Office doesn't even come with most pc laptops.	iWork	-1
Keyboard is plastic and spongey feeling.	Keyboard	-1
previous laptops were pc's, still have them, but the mac osx is a clean and smooth operating system.	mac osx	1
i also love having the extra calculator number set up on the keyboard which most laptops do not have.	keyboard	1
Because he said that the hinge is under the motherboard and they have to dismantle the whole thing before it can be tightened.	hinge	0
You can do it all on this bad boy but the main thing this netbook was desinged for was surfing the web and boy o boy does it ever.	surfing the web	1
I love my Apple, it is quick and easy to use.	use	1
With notes saying they replaced the hard drive.	hard drive	0
The laptop is relatively simple to use, though I bought  Macs for Dummies,  which is well worth $2	use	1
Can't close the 2nd HDD bay since there are brackets you have to break off (even then, it still doesn't shut) That could be a major flaw for the dual HDD user.	HDD bay	-1
No tutorials on the display.	tutorials	-1
The leather carrying case, keyboard and mouse arrived in two days from Memphis warehouse.	leather carrying case	0
The touch pad is among the best.	touch pad	1
"Thus, when you carry it at a slanted angle, the screen will ""topple"" or ""slide"" down, if you understand what I mean."	screen	-1
It's now all commodity hardware.	commodity hardware	0
I would like to use a different operating system altogether.	operating system	0
